"name"	"name:ca"	"alt_name:ca"	"alt_name"	"translations"	"ca.wikipedia_page"	"wikidata_id"
"Calle Aadisa"						
"Calle Marjaleta"	"Carrer Marjaleta"					
"Calle 9 d'Octubre"	"Carrer 9 d'Octubre"					
"Calle Ensanche"	"Carrer de l’Eixample"					
"Calle de la Travesía Camino de Foya"	"Carrer de la Travessia Camí de la Foia"					
"Calle de la Cooperativa"	"Carrer de la Cooperativa"					
"Calle Hort de Marçal"	"Carrer Hort de Marçal"					
"Calle Hort de Cano"	"Carrer Hort de Cano"					
"Calle Hort de Don Gregori"	"Carrer Hort de Don Gregori"					
"Calle Hort de Xolo"	"Carrer Hort de Xolo"					
"Calle de San Roque"	"Carrer de Sant Roc"					
"Calle Hort de Calafre"	"Carrer Hort de Calafre"					
"Calle Hort de Miralles"	"Carrer Hort de Miralles"					
"Calle Hort de Canarieta"	"Carrer Hort de Canarieta"					
"Calle Sierra de Aitana"	"Carrer Serra d’Aitana"					
"Calle de San Antonio"	"Carrer de Sant Antoni"					
"Calle Maestro Serrano"	"Carrer Mestre Serrano"					
"Calle de José Capuz"	"Carrer de José Capuz"					
"Calle de Silla"	"Carrer de Silla"					
"Calle Alaquas"	"Carrer Alaquàs"					
"Calle de Picaña"	"Carrer de Picanya"					
"Calle de Lepanto"	"Carrer de Lepant"	"Carrer de Lepanto"				
"Calle de Favara"	"Carrer de Favara"					
"Calle de Luis Vives"	"Carrer de Lluís Vives"					
"Calle Industria"	"Carrer Indústria"					
"Calle de la Sagrada Familia"	"Carrer de la Sagrada Família"					
"Calle de San José"	"Carrer de Sant Josep"					
"Calle de Federico García Lorca"	"Carrer de Federico García Lorca"					
"Calle del Primero de Mayo"	"Carrer del Primer de Maig"					
"Calle de San Jorge"	"Carrer de Sant Jordi"					
"Calle Virgen de los Desamparados"	"Carrer Mare de Déu dels Desemparats"					
"Calle Sierra de Mariola"	"Carrer Serra de Mariola"					
"Calle del Palleter"	"Carrer del Palleter"					
"Calle del Poeta Llorente"	"Carrer del Poeta Llorente"					
"Calle de Nueve de Octubre"	"Carrer del Nou d’Octubre"					
"Calle de San Juan de Ribera"	"Carrer de Sant Joan de Ribera"					
"Calle de San Ramón"	"Carrer de Sant Ramon"					
"Calle del Doctor Marañón"	"Carrer del Doctor Marañón"					
"Calle de Luis Martí"	"Carrer de Luis Martí"					
"Calle del Cardenal Benlloch"	"Carrer del Cardenal Benlloch"					
"Calle de Rafael Ribelles"	"Carrer de Rafael Ribelles"					
"Calle Don Juan de Austria"	"Carrer d’en Joan d’Àustria"					
"Calle de San Joaquín"	"Carrer de Sant Joaquim"					
"Calle Portugal"	"Carrer de Portugal"					
"Calle de San Eduardo"	"Carrer de Sant Eduard"					
"Calle del Marqués del Turia"	"Carrer del Marqués del Túria"					
"Calle de Alacuás"	"Carrer d’Alaquàs"					
"Calle Porvenir"	"Carrer del Porvenir"	"Carrer de l’Avenir"	"Carrer de l’Avenir"			
"Calle de Clara Campoamor"	"Carrer de Clara Campoamor"					
"Calle de Luis Dubón"	"Carrer de Luis Dubón"					
"Calle de Pío XII"	"Carrer de Pius XII"					
"Calle Alcasser"	"Carrer Alcàsser"					
"Calle de Picasent"	"Carrer de Picassent"					
"Calle de San Elías"	"Carrer de Sant Elies"					
"Calle Severo Ochoa"	"Carrer Severo Ochoa"					
"Calle José Escrivà Sos"	"Carrer José Escrivà Sos"					
"Calle Séquia Reial del Xúquer"	"Carrer Séquia Reial del Xúquer"					
"Calle de Sant Vicenç"	"Carrer de Sant Vicent"					
"Calle Hort"	"Carrer de l’Hort"					
"Calle de Antonio Maura"	"Carrer d’Antonio Maura"					
"Calle de San Pedro"	"Carrer de Sant Pere"					
"Calle Beniparrell"	"Carrer Beniparrell"					
"Calle Séquia Favara"	"Carrer Séquia Favara"					
"Calle Futbolista José Paredes"	"Carrer Futbolista José Paredes"					
"Calle Vicente Martínez"	"Carrer Vicente Martínez"					
"Calle Abogada Clara Campoamor"	"Carrer Advocada Clara Campoamor"					
"Calle Juan Ramón Jiménez"	"Carrer Juan Ramón Jiménez"					
"Calle José Echegaray"	"Carrer José Echegaray"					
"Calle Miguel Hernández"	"Carrer Miguel Hernández"					
"Calle Cronista Jesús Emilio Sanchís"	"Carrer Cronista Jesús Emilio Sanchís"					
"Calle de Juan Esteve"	"Carrer de Juan Esteve"					
"Calle de la Torre"	"Carrer de la Torre"					
"Calle de José María Penán"	"Carrer de José María Penán"					
"Calle de Don Blas Margalef"	"Carrer de Don Blas Margalef"					
"Calle Tabacalera"	"Carrer de la Tabacalera"					
"Calle Santiago Miralles"	"Carrer Santiago Miralles"					
"Calle Pintor Picasso"	"Carrer Pintor Picasso"					
"Calle Rei en Jaume"	"Carrer Rei en Jaume"					
"Calle El Palleter"	"Carrer El Palleter"					
"Calle Maria Benlliure"	"Carrer Maria Benlliure"					
"Calle Número 13"						
"Calle del Atleta Fausto Albiol"	"Carrer de l’Atleta Fausto Albiol"					
"Calle de San Carlos"	"Carrer de Sant Carles"					
"Calle de Catarroja"	"Carrer de Catarroja"					
"Calle de Salvador Ricart"	"Carrer de Salvador Ricart"					
"Calle de Torrente"	"Carrer de Torrent"					
"Calle de Don Mauro Guillem"	"Carrer de Mauro Guillem"					
"Calle de Eusebio Gimeno"	"Carrer d’Eusebio Gimeno"					
"Calle del Maestro Serrano"	"Carrer del Mestre Serrano"					
"Calle Virgen de los Angeles"	"Carrer Mare de Déu dels Àngels"					
"Calle de Alcácer"	"Carrer d’Alcàsser"					
"Calle de Colón"	"Carrer de Colom"					
"Calle Rector Peset Aleixandre"	"Carrer Rector Peset Aleixandre"					
"Calle de Hernández Lázaro"	"Carrer de Hernández Lázaro"					
"Calle de San Blas"	"Carrer de Sant Blai"					
"Calle Reino de Valencia"	"Carrer Regne de València"					
"Calle Julio Nebot"	"Carrer Julio Nebot"					
"Calle Les Llargues"	"Carrer les Llargues"					
"Calle de Salvador Rodrigo"	"Carrer de Salvador Rodrigo"					
"Calle Joventut Musical d'Albal"	"Carrer Joventut Musical d'Albal"					
"Calle Paiporta"	"Carrer de Paiporta"					
"Calle de Paiporta"	"Carrer de Paiporta"					
"Calle La Senyera"	"Carrer de la Senyera"					
"Calle de Lauria"	"Carrer de Lauria"					
"Calle de Buenavista"	"Carrer de Bonavista"					
"Calle del Doctor Cajal"	"Carrer del Doctor Cajal"					
"Calle Santiago"	"Carrer Santiago"					
"Calle San Rafael"	"Carrer Sant Rafael"					
"Calle de la Cruz"	"Carrer de la Creu"					
"Calle de Andrés Codoñer"	"Carrer d’Andrés Codoñer"					
"Calle de la Claridad"	"Carrer de la Caritat"					
"Calle de la Albufera"	"Carrer de l’Albufera"					
"Calle del Doctor Joan Peset"	"Carrer del Doctor Joan Peset"					
"Calle Canaleta"	"Carrer Canaleta"					
"Calle de Hernán Cortés"	"Carrer d’Hernán Cortés"					
"Calle Virgen Milagrosa"	"Carrer Mare de Déu dels Miracles"					
"Calle de Juan de Juanes"	"Carrer de Juan de Juanes"					
"Calle del Motor de la Acequia Ferrer"	"Carrer del Motor de la Séquia Ferrer"					
"Calle de Ausiás March"	"Carrer d’Ausiàs March"					
"Calle de Segorbe"	"Carrer de Sogorb"					
"Calle de Castellar"	"Carrer de Castellar"					
"Calle de Chiva"	"Carrer de Xiva"					
"Calle de Concepción Arenal"	"Carrer de Concepción Arenal"					
"Calle de Joanot Martorell"	"Carrer de Joanot Martorell"					
"Calle Nueve de Octubre"	"Carrer del Nou d’Octubre"					
"Calle de Alcoy"	"Carrer d’Alcoi"					
"Calle del Literato Azorín"	"Carrer del Literat Azorín"					
"Calle de José Antequera"	"Carrer de José Antequera"					
"Calle de la Resurrección"	"Carrer de la Resurrecció"					
"Calle de Teodoro Llorente"	"Carrer de Teodor Llorente"					
"Calle de Francisco Nácher Pons"	"Carrer de Francisco Nácher Pons"					
"Calle de los Condes de Trigona"	"Carrer dels Comtes de Trigona"					
"Calle de Pi y Maragall"	"Carrer de Pi i Maragall"					
"Calle Libertad"	"Carrer de la Llibertat"					
"Calle de San Abdón"	"Carrer de Sant Abdó"					
"Calle de San Vicente"	"Carrer de Sant Vicent"					
"Calle del Ángel"	"Carrer de l’Àngel"					
"Calle del Polideportivo"	"Carrer del Poliesportiu"					
"Calle San Pascual"	"Carrer Sant Pasqual"					
"Calle Animas"	"Carrer Ànimes"					
"Calle Paz"	"Carrer de la Pau"					
"Calle de los Membrillos"	"Carrer Camí dels Codonyers"					
"Calle Número 6"						
"Calle del Camino Fus"	"Carrer del Camí Fus"					
"Calle Número 7"						
"Calle de Algemesí"	"Carrer d’Algemesí"					
"Calle de Gregorio Mayans"	"Carrer de Gregori Mayans"					
"Calle de Garaz Liebenau"	"Carrer de Garaz Liebenau"					
"Calle de Orba"	"Carrer d’Orba"					
"Calle de la Acequia Favara"	"Carrer de la Séquia de Favara"					
"Calle de Jaime Balmes"	"Carrer de Jaume Balmes"					
"Calle de Albal"	"Carrer d’Albal"					
"Calle de San Miguel"	"Carrer de Sant Miquel"					
"Calle de Manuel Sanchis Guarner"	"Carrer de Manuel Sanchis Guarner"					
"Calle de la Alquería de Soria"	"Carrer de l’Alqueria de Soria"					
"Calle de Isabel de Villena"	"Carrer d’Isabel de Villena"					
"Calle de Ocho de Marzo"	"Carrer del Vuit de Març"					
"Calle de José Codoñer Casañ"	"Carrer de José Codoñer Casañ"					
"Calle de San Juan"	"Carrer de Sant Joan"					
"Calle de la Fuente Cabilda"	"Carrer de la Font de la Cabilda"					
"Calle de la Huerta"	"Carrer de l’Horta"					
"Calle de Francisco de Vinatea"	"Carrer de Francesc de Vinatea"					
"Calle del Doctor Gil López"	"Carrer del Doctor Gil López"					
"Calle de la Cruz Roja"	"Carrer de la Creu Roja"					
"Calle de Fermín Vilar"	"Carrer de Fermín Vilar"					
"Calle del Profesor Ventura Alabau"	"Carrer del Professor Ventura Alabau"					
"Calle del Alcalde José Puertas"	"Avinguda de l’Alcalde José Puertes"					
"Calle Párroco Jacinto Vicente"	"Carrer del Rector Jacinto Vicente"					
"Calle de la Profesora Ana Rojo"	"Carrer de la Professora Ana Rojo"					
"Calle Rabisancho"	"Carrer Rabisancho"					
"Calle de José Ruiz Azorín"	"Carrer de José Ruiz Azorín"					
"Calle Garbí"	"Carrer Garbí"					
"Calle Sierra de Perenxisa"	"Carrer Serra de Perenxisa"					
"Calle del Maestro Palau"	"Carrer del Mestre Palau"					
"Calle de Quart de Poblet"	"Carrer de Quart de Poblet"					
"Calle Acequia de Favara"	"Carrer Séquia de Favara"					
"Calle de los Conductores"	"Carrer dels Conductors"					
"Calle de los Planchistas"	"Carrer dels Planxistes"					
"Calle de las Artes Gráficas"	"Carrer de les Arts Gràfiques"					
"Calle de los Herreros"	"Carrer dels Ferrers"					
"Calle de l'Horta"	"Carrer de l'Horta"					
"Calle de Ausias March"	"Carrer d’Ausiàs March"					
"Calle Manises"	"Carrer Manises"					
"Calle Acequia de MIslata"	"Carrer Séquia de Mislata"					
"Calle Acequia Rascanya"	"Carrer Séquia de Rascanya"					
"Calle de Massalfassar"	"Carrer de Massalfassar"					
"Calle de los Carpinteros"	"Carrer dels Fusters"					
"Calle Moncada"	"Carrer Montcada"					
"Calle de San Francisco"	"Carrer de Sant Francesc"					
"Calle de Alfafar"	"Carrer d’Alfafar"					
"Calle Banda Primitiva de Paiporta"	"Carrer Banda Primitiva de Paiporta"					
"Calle de la Maestra Doña Juana"	"Carrer de la Mestra Doña Juana"	"Carrer de la Mestre na Juana"	"Carrer de la Mestre na Juana"			
"Calle José Iburbi"	"Carrer de José Iburbi"					
"Calle de Francisco Tárrega"	"Carrer de Francisco Tárrega"					
"Calle Alqueria Quinfo"	"Carrer Alqueria Quinfo"					
"Calle del Padre Jorge María"	"Carrer del Pare Jordi Maria"					
"Calle de Antonio Machado"	"Carrer de Antonio Machado"					
"Calle del Médico Peset"	"Carrer del Metge Peset"					
"Calle de San Dionisio"	"Carrer de Sant Dionís"					
"Calle de Pelayo"	"Carrer de Pelayo"	"Carrer de Pelai"				
"Calle del Convento"	"Carrer del Convent"					
"Calle Doctor Ramón y Cajal"	"Carrer Doctor Ramón y Cajal"					
"Calle de Enrique Reig"	"Carrer d’Enrique Reig"					
"Calle Pintor Benedicto"	"Carrer Pintor Benedicto"					
"Calle Puebla de Farnals"	"Carrer Pobla de Farnals"					
"Calle Sedaví"	"Carrer Sedaví"					
"Calle de Gabriel Miró"	"Carrer de Gabriel Miró"					
"Calle de los Tapiceros"	"Carrer dels Tapissers"					
"Calle Joaquín Renovell"	"Carrer Joaquín Renovell"					
"Calle Pablo Neruda"	"Carrer Pablo Neruda"					
"Calle Juan Barral"	"Carrer Juan Barral"					
"Calle de Juan Bautista Basset y Ramos"	"Carrer de Juan Bautista Basset y Ramos"					
"Calle de la Acequia de Favara"	"Carrer de la Séquia de Favara"					
"Calle Horta"	"Carrer de l’Horta"					
"Calle Maestra Juana Sena"	"Carrer Mestra Juana Sena"					
"Calle el Palleter"	"Carrer del Palleter"					
"Calle del Doctor Perpiñá"	"Carrer del Doctor Perpiña"					
"Calle del Párroco Eduardo Ballester"	"Carrer del Rector Eduardo Ballester"					
"Calle de Aldaya"	"Carrer d’Aldaia"					
"Calle de Alcira"	"Carrer d’Alzira"					
"Calle de Onteniente"	"Carrer d’Ontinyent"					
"Calle de Benetúser"	"Carrer de Benetússer"					
"Calle de Masanasa"	"Carrer de Massanassa"					
"Calle Lugar Nuevo de la Corona"	"Carrer Llocnou de la Corona"					
"Calle de Pintor Sorolla"	"Carrer de Pintor Sorolla"					
"Calle de Isabel La Católica"	"Carrer d’Isabel la Catòlica"					
"Calle de Fernando El Católico"	"Carrer de Ferran el Catòlic"					
"Calle de Las Américas"	"Carrer de les Amèriques"					
"Calle de Lope de Vega"	"Carrer de Lope de Vega"					
"Calle Número 22"						
"Calle del Almirante Císcar"	"Carrer de l’Almirall Císcar"					
"Calle de la Murta"	"Carrer de la Murta"					
"Calle Maestra Rosario Iroil"	"Carrer Mestra Rosario Iroil"					
"Calle Ciudad de Calatayud"	"Carrer Ciutat de Calatayud"					
"Calle del Dr. José Peris"	"Carrer del Doctor José Peris"					
"Calle Maestra Carmen Benages"	"Carrer Mestra Carmen Benages"					
"Calle Creu Roja"	"Carrer de la Creu Roja"					
"Calle de Mariano Benlliure"	"Carrer de Mariano Benlliure"					
"Calle del Maestro García Zapater"	"Carrer del Mestre García Zapater"					
"Calle de Nuestra Señora del Socorro"	"Carrer de la Mare de Déu del Socors"	"Carrer de la Mare de Déu del Socorro"	"Carrer de la Mare de Déu del Socorro"			
"Calle de Juan Sebastián Elcano"	"Carrer de Juan Sebastián Elcano"					
"Calle de Pintor Ribera"	"Carrer del Pintor Ribera"					
"Calle de Jaime I El Conquistador"	"Carrer de Jaume I el Conqueridor"					
"Calle de Francisco Almarche"	"Carrer de Francisco Almarche"					
"Calle de Juan Martínez Company"	"Carrer de Juan Martínez Company"					
"Calle de los Pintores"	"Carrer dels Pintors"					
"Calle de los Mecánicos"	"Carrer dels Mecànics"					
"Calle de Miguel Hernández"	"Carrer de Miguel Hernández"					
"Calle del 9 de Octubre"	"Carrer del 9 d’Octubre"					
"Calle de Madrid"	"Carrer de Madrid"					
"Calle Monte Alto"	"Carrer Monte Alto"					
"Calle de Menéndez Pelayo"	"Carrer de Menéndez Pelayo"					
"Calle del Dos de Mayo"	"Carrer del Dos de Maig"					
"Calle del Doctor Felming"	"Carrer del Doctor Fleming"					
"Calle de Castell de Olite"	"Carrer del Castell d’Olite"					
"Calle Maestro Chapi"	"Carrer del Mestre Chapí"					
"Calle de Juan XXIII"	"Carrer de Joan XXIII"					
"Calle de José Segrelles"	"Carrer de José Segrelles"					
"Calle Banda Unión Musical"	"Carrer Banda Unió Musical"					
"Calle de Covadonga"	"Carrer de Covadonga"					
"Calle Mariana Pineda"	"Carrer Mariana Pineda"					
"Calle del Doctor López Trigo"	"Carrer del Doctor López Trigo"					
"Calle de Miguel Grau"	"Carrer de Miquel Grau"					
"Calle de San Juan Bosco"	"Carrer de Sant Joan Bosco"					
"Calle Echegaray"	"Carrer Echegaray"					
"Calle de Bonrepós y Mirambell"	"Carrer de Bonrepòs i Mirambell"					
"Calle Polonia"	"Carrer de Polònia"					
"Calle Finlandia"	"Carrer de Finlàndia"					
"Calle Chipre"	"Carrer de Xipre"					
"Calle Malta"	"Carrer de Malta"					
"Calle Países Bajos"	"Carrer Països Baixos"					
"Calle Eslovaquia"	"Carrer Eslovàquia"					
"Calle Museros"	"Carrer Museros"					
"Calle Lituania"	"Carrer Lituània"					
"Calle de Jaime I"	"Carrer de Jaume I"					
"Calle de Maximiliano Thous"	"Carrer de Maximiliano Thous"					
"Calle de Acequia de Quart"	"Carrer de Séquia de Quart"					
"Calle de San Sebatián"	"Carrer de Sant Sebastià"					
"Calle de Isaac Peral"	"Carrer d’Isaac Peral"					
"Calle de Salvador Giner"	"Carrer de Salvador Giner"					
"Calle del Cid Campeador"	"Carrer del Cid Campeador"					
"Calle Manuel Baixauli Andrés"	"Carrer Manuel Baixauli Andrés"					
"Calle del Doctor Don Manuel Barrachina"	"Carrer del Doctor Don Manuel Barrachina"					
"Calle de Eduardo Escalante"	"Carrer d’Eduardo Escalante"					
"Calle de San Cayetano"	"Carrer de Sant Gaietà"					
"Calle Francisco Baixauli"	"Carrer Francisco Baixauli"					
"Calle Sequia Favara"	"Carrer Séquia Favara"					
"Calle José María Morales"	"Carrer de José María Morales"					
"Calle Músico Francisco Burguera"	"Carrer Músic Francisco Burguera"					
"Calle de José María Morales"	"Carrer de José María Morales"					
"Calle Numero Uno"						
"Calle de Horta"	"Carrer de l’Horta"					
"Calle de la Sequi de Calvera"	"Carrer de la Séquia de Calvera"					
"Calle del Médico Ernesto Andreu Minguet"	"Carrer del Metge Ernesto Andreu Minguet"					
"Calle de Morella"	"Carrer de Morella"					
"Calle Divisoria"	"Carrer Divisòria"					
"Calle de Germanías"	"Carrer de les Germanies"					
"Calle de la Libertad"	"Carrer de la Llibertat"					
"Calle Amadeo Ruiz Olmos"	"Carrer Amadeo Ruiz Olmos"					
"Calle de Vicente Andrés Estellés"	"Carrer de Vicent Andrés Estellés"					
"Calle de la Alcoholera"	"Carrer de l’Alcoholera"					
"Calle de Vicente Blasco Ibáñez"	"Carrer de Vicente Blasco Ibáñez"					
"Calle de la Virgen del Rosario"	"Carrer de la Mare de Déu del Rosari"					
"Calle de San Torcuato"	"Carrer de Sant Torquat"					
"Calle de García Sanchís"	"Carrer de García Sanchís"					
"Calle de Francisco Vila El Morenet"	"Carrer de Francisco Vila el Morenet"					
"Calle de la Tauleta"	"Carrer de la Tauleta"					
"Calle de Julio Colomer"	"Carrer de Julio Colomer"					
"Calle de la Veleta"	"Carrer de la Veleta"					
"Calle del Doctor Ferrán"	"Carrer del Doctor Ferran"					
"Calle de la Fuensanta"	"Carrer de la Font Santa"					
"Calle 9 d'octubre"	"Carrer del 9 d'Octubre"					
"Calle del Mestre Benages"	"Carrer del Mestre Benages"					
"Calle de los Deportes"	"Carrer dels Esports"					
"Calle del Capitán Cortés"	"Carrer del Capità Cortés"					
"Calle Ramón Lacreu"	"Carrer Ramón Lacreu"					
"Calle de Benito Pérez Galdós"	"Carrer de Benito Pérez Galdós"					
"Calle del Musical"	"Carrer del Musical"					
"Calle 25 d'Abril"	"Carrer del 25 d'Abril"					
"Calle Pinedo"	"Carrer de Pinedo"					
"Calle de Antonio Tarazona"	"Carrer d’Antonio Tarazona"					
"Calle Xativa"	"Carrer de Xàtiva"					
"Calle del Medio"	"Carrer del Mig"					
"Calle de Fernando Baixauli Chomet"	"Carrer de Fernando Baixauli Chomet"					
"Calle del Azagador de la Torre"	"Carrer de l’Assagador de la Torre"					
"Calle de Fernando Giner de los Ríos"	"Carrer de Fernando Giner de los Ríos"					
