"name"	"name:ca"	"alt_name:ca"	"alt_name"	"translations"	"ca.wikipedia_page"	"wikidata_id"
"Calle Cuenca, 23"	"Carrer Conca, 23"					
"Calle Cuenca, 7"	"Carrer Conca, 7"					
"Calle Luis Portabella / Estación Renfe"	"Carrer Luis Portabella / Estació Renfe"					
"Calle Hernán Cortés / Estación Renfe"	"Carrer Hernán Cortés / Estació Renfe"					
"Calle Mayor, 87 / Tableros Folgado"	"Carrer Major, 87 / Tableros Folgado"					
"Calle Miguel Hernández, 3 / Cochera"	"Carrer Miguel Hernández, 3 / Cotxera"					
"Calle Miguel Hernández, 44 / Colegio"	"Carrer Miguel Hernández, 44 / Col·legi"					
"Calle Miguel Hernández, 54 / Bar Luján"	"Carrer Miguel Hernández, 54 / Bar Luján"					
"Calle Miguel Hernández, 8"	"Carrer Miguel Hernández, 8"					
"Calle Coladores, 49"	"Carrer Coladors, 49"					
"Calle Solidaridad (Las Greñas)"	"Carrer Solidaritat (Las Greñas)"					
"Calle Solidaridad / La Cautiva"	"Carrer Solidaritat / La Cautiva"					
"Calle La Fuente"	"Carrer la Font"					
"Calle de Fuerteventura"	"Carrer de Fuerteventura"					
"Calle 9 Núcleo 22"	"Carrer 9 Nucli 22"					
"Calle 7 Nucleo 22"	"Carrer 7 Nucli 22"					
"Calle 2 Núcleo 22"	"Carrer 2 Nucli 22"					
"Calle del Mar Jónico"	"Carrer de la Mar Jònica"					
"Calle Escultor José Capuz"	"Carrer Escultor José Capuz"					
"Calle de Pinedo"	"Carrer de Pinedo"					
"Calle Barranco de Chiva"	"Carrer Barranc de Xiva"					
"Calle Barranc del Galileo"	"Carrer Barranc del Galileu"					
"Calle Rosalia de Castro"	"Carrer Rosalia de Castro"					
"Calle del Cronista Vicent Beguer Esteve"	"Carrer del Cronista Vicent Beguer Esteve"					
"Calle Pintor Francisco Domingo"	"Carrer Pintor Francisco Domingo"					
"Calle Teixedors"	"Carrer Teixidors"					
"Calle Fusters"	"Carrer Fusters"					
"Calle Fernando Rodríguez Fornos"	"Carrer Fernando Rodríguez Fornos"					
"Calle del Marino"						
"Calle Londres 48"	"Carrer Londres 48"					
"Calle Ramón Menéndez Pidal"	"Carrer Ramón Menéndez Pidal"					
"Calle Virgen de la Soledad"	"Carrer Mare de Déu de la Soledat"					
"Calle Cronista Silvino Beney"	"Carrer Cronista Silvino Beney"					
"Calle Beniparrell"	"Carrer Beniparrell"					
"Calle Gómez Ferrer"	"Carrer Gómez Ferrer"					
"Calle San Cayetano"	"Carrer Sant Gaietà"					
"Calle de Hernán Cortés"	"Carrer d’Hernán Cortés"					
"Calle de Orihuela"	"Carrer d’Oriola"					
"Calle de José Capuz"	"Carrer de José Capuz"					
"Calle de Clara Campoamor"	"Carrer de Clara Campoamor"					
"Calle de San Juan Bautista"	"Carrer de Sant Joan Baptista"					
"Calle de los Hospitalarios"	"Carrer dels Hospitalaris"					
"Calle de San José"	"Carrer de Sant Josep"					
"Calle de la Preciosísima Sangre"	"Carrer de la Preciosíssima Sang"					
"Calle Virgen del Pilar"	"Carrer Mare de Déu del Pilar"					
"Calle de San Antonio Abad"	"Carrer de Sant Antoni Abad"					
"Calle del Doctor Gómez Ferrer"	"Carrer del Doctor Gómez Ferrer"					
"Calle de Torrente"	"Carrer de Torrent"					
"Calle de San Francisco"	"Carrer de Sant Francesc"					
"Calle de la Senyera"	"Carrer de la Senyera"					
"Calle de Luis Vives"	"Carrer de Lluís Vives"					
"Calle Marqués del Turia"	"Carrer Marqués del Túria"					
"Calle de San Vicente"	"Carrer de Sant Vicent"					
"Calle de Ramón y Cajal"	"Carrer de Ramón y Cajal"					
"Calle del Doctor Herrero"	"Carrer del Doctor Herrero"					
"Calle Sierra de Mariola"	"Carrer Serra de Mariola"					
"Calle de Colón"	"Carrer de Colom"					
"Calle de Buenavista"	"Carrer de Bonavista"					
"Calle Virgen del Carmen"	"Carrer Mare de Déu del Carme"					
"Calle de San Pascual"	"Carrer de Sant Pasqual"					
"Calle de Taronja"	"Carrer de Taronja"					
"Calle Almassereta (s.XVIII-s.XIX)"	"Carrer Almassereta (s.XVIII-s.XIX)"					
"Calle de la Alquería Florentina"	"Carrer de l’Alqueria Florentina"					
"Calle de la Alquería Mangarrota"	"Carrer de l’Alqueria Mangarrota"					
"Calle de la Alquería Rulla"	"Carrer de l’Alqueria Rulla"					
"Calle de la Alquería Serrador"	"Carrer de l’Alqueria Serrador"					
"Calle de Catarroja"	"Carrer de Catarroja"					
"Calle de Aldaya"	"Carrer d'Aldaia"					
"Calle 8 de Marzo"	"Carrer 8 de Març"					
"Calle de Mariana Pineda"	"Carrer de Mariana Pineda"					
"Calle Vent de Llebeig"	"Carrer Vent de Llebeig"					
"Calle Vent de Mestral"	"Carrer Vent de Mestral"					
"Calle Vent de Garbí"	"Carrer Vent de Garbí"					
"Calle de Tirant lo Blanc"	"Carrer de Tirant lo Blanc"					
"Calle Montaña del Garbí"	"Carrer Muntanya del Garbí"					
"Calle de Germanías"	"Carrer de les Germanies"					
"Calle Vent de Migjorn"	"Carrer Vent de Migjorn"					
"Calle Zenobia Camprubí"	"Carrer Zenobia Camprubí"					
"Calle de Concepción Arenal"	"Carrer de Concepción Arenal"					
"Calle Emilia Bazan"	"Carrer Emilia Pardo Bazan"					
"Calle de Gloria Fuertes"	"Carrer de Gloria Fuertes"					
"Calle de Alacuás"	"Carrer d’Alaquàs"					
"Calle de Rosa de Luxemburgo"	"Carrer de Rosa de Luxemburg"					
"Calle de María Zambrano"	"Carrer de María Zambrano"					
"Calle de Marie Curie"	"Carrer de Marie Curie"					
"Calle de Isabel de Villena"	"Carrer d’Isabel de Villena"					
"Calle de Joan Fuster"	"Carrer de Joan Fuster"					
"Calle de Violante de Hungría"	"Carrer de Violant d’Hongria"					
"Calle de Carmen Martín Gaite"	"Carrer de Carmen Martín Gaite"					
"Calle de María de Molina"	"Carrer de María de Molina"					
"Calle de Vicente Andrés Estellés"	"Carrer de Vicent Andrés Estellés"					
"Calle de José Renau"	"Carrer de Josep Renau"					
"Calle de Matilde Salvador"	"Carrer de Matilde Salvador"					
"Calle de Picaña"	"Carrer de Picanya"					
"Calle de Chirivella"	"Carrer de Xirivella"					
"Calle de Paiporta"	"Carrer de Paiporta"					
"Calle de Rosalía de Castro"	"Carrer de Rosalía de Castro"					
"Calle del Argeaga"	"Carrer de l’Argelaga"					
"Calle de la Falzia"	"Carrer de la Falzia"					
"Calle del Esparver"	"Carrer de l’Esparver"					
"Calle de Loroneta"	"Carrer de l’Oroneta"					
"Calle Colada de Aragón"	"Carrer Colada d’Aragó"					
"Calle del Río Gudalaviar"	"Carrer del Riu Guadalaviar"					
"Calle Río Magro"	"Carrer Riu Magre"					
"Calle Río Vinalopó"	"Carrer Riu Vinalopó"					
"Calle del Río Tuéjar"	"Carrer del Riu Toixa"					
"Calle de Llanterners"	"Carrer de Llanterners"					
"Calle de las Trece Rosas"	"Carrer de les Tretze Roses"					
"Calle de Flora Tristán"	"Carrer de Flora Tristán"					
"Calle de Palmiters"	"Carrer de Palmiters"					
"Calle Tapissers"	"Carrer Tapissers"					
"Calle de Jaime I"	"Carrer de Jaume I"					
"Calle Torners"	"Carrer Torners"					
"Calle de Coheters"	"Carrer dels Coeters"					
"Calle de Aladrers"	"Carrer de Aladrers"					
"Calle de Traginers"	"Carrer de Traginers"					
"Calle de Cullerers"	"Carrer de Cullerers"					
"Calle de Emilia Pardo Bazán"	"Carrer d’Emilia Pardo Bazán"					
"Calle Ocho de Marzo"	"Carrer Vuit de Març"					
"Calle del Trabajo"	"Carrer del Treball"					
"Calle Río Serpis"	"Carrer Riu Serpis"					
"Calle del Río Gorgos"	"Carrer del Riu Gorgos"					
"Caller Río Clariano"	"Carrer Riu Clariano"					
"Calle Río Clariano"	"Carrer Riu Clariano"					
"Calle del Río Segura"	"Carrer del Riu Segura"					
"Calle Río Sec"	"Carrer Riu Sec"					
"Calle del Río Cabriel"	"Carrer del Riu Cabriol"					
"Calle de la Acequia de Favara"	"Carrer de la Séquia de Favara"					
"Calle de la Pinadeta"	"Carrer de la Pinadeta"					
"Calle Sierra de Aitana"	"Carrer Serra d’Aitana"					
"Calle de la Acequia de Tormos"	"Carrer de la Séquia de Tormos"					
"Calle de la Perdiz"	"Carrer de la Perdiu"					
"Calle Fumarell"	"Carrer Fumarell"					
"Calle del Águila Xotera"	"Carrer de l’Àguila Xotera"					
"Calle de la Fotja"	"Carrer de la Fotja"					
"Calle del Rat Penat"	"Carrer del Rat Penat"					
"Calle del Coll Verd"	"Carrer del Coll Verd"					
"Calle de la Gaviota"	"Carrer de la Gavina"					
"Calle del Lentisco"	"Carrer del Llentiscle"					
"Calle de la Murta"	"Carrer de la Murta"					
"Calle de la Savina"	"Carrer de la Savina"					
"Calle del Esquirol"	"Carrer de l’Esquirol"					
"Calle del Pi Roig"	"Carrer del Pi Roig"					
"Calle Piuleta Blanca"	"Carrer Piuleta Blanca"					
"Calle del Corriol"	"Carrer del Corriol"					
"Calle del Escabussonet"	"Carrer del Escabussonet"					
"Calle del Halcón de la Reina"	"Carrer del Falcó de la Reina"					
"Calle de la Cadernera"	"Carrer de la Cadernera"					
"Calle de la Faig"	"Carrer del Faig"					
"Calle de Manises"	"Carrer de Manises"					
"Calle del Canal Júcar-Turia"	"Carrer del Canal Xúquer-Túria"					
"Calle del Río Palancia"	"Carrer del Riu Palància"					
"Calle del Río Canyoles"	"Carrer del Riu Canyoles"					
"Calle del Sargento Provisional"	"Carrer del Sergent Provisional"					
"Calle del General Lobo Montero"	"Carrer del General Lobo Montero"					
"Calle de Ciudad de Mudeco"	"Carrer de Ciutat de Mudeco"					
"Calle del Pintor Joaquín Sorolla"	"Carrer del Pintor Joaquín Sorolla"					
"Calle del Ejército del Aire"	"Carrer de l’Exèrcit de l’Aire"					
"Calle Virgen de Loreto"	"Carrer Mare de Déu de Loreto"					
"Calle de Lepanto"	"Carrer de Lepant"	"Carrer de Lepanto"				
"Calle del General Orgaz"	"Carrer del General Orgaz"					
"Calle dels Furs"	"Carrer dels Furs"					
"Calle de la Vereda"	"Carrer de la Vereda"					
"Calle Bajo Segura"	"Carrer Baix Segura"					
"calle del Cid"	"carrer del Cid"					
"Calle de Silla"	"Carrer de Silla"					
"Calle de Alcoy"	"Carrer d’Alcoi"					
"Calle de Cádiz"	"Carrer de Cadis"					
"Calle del Miguelete"	"Carrer del Miquelet"					
"Calle Hermanos Lluna"	"Carrer Germans Lluna"					
"Calle de las Palmeras"	"Carrer de les Palmeres"					
"Calle Melitón Comes"	"Carrer Melitón Comes"					
"Calle de Velázquez"	"Carrer de Velázquez"					
"Calle Martínez Torres"	"Carrer Martínez Torres"					
"Calle del Cardenal Tarancón"	"Carrer del Cardenal Tarancón"					
"Calle San Fernando"	"Carrer Sant Ferran"					
"Calle Eduardo Chillida"	"Carrer Eduardo Chillida"					
"Calle Andreu Alfaro"	"Carrer Andreu Alfaro"					
"Calle San Luis"	"Carrer Sant lluís"					
"Calle de Alicante"	"Carrer d’Alacant"					
"Calle de San Cristóbal"	"Carrer de Sant Cristòfol"					
"Calle San Luis Gonzaga"	"Carrer Sant Lluís Gonzaga"					
"Calle de Joaquín Blume"	"Carrer de Joaquín Blume"					
"Calle de Federico García Lorca"	"Carrer de Federico García Lorca"					
"Calle del Doctor Marañón"	"Carrer del Doctor Marañón"					
"Calle de Antonia María de Oviedo"	"Carrer d’Antonia María de Oviedo"					
"Calle Bernabé Sanchís"	"Carrer Bernabé Sanchís"					
"Calle Párroco Francisco Revert"	"Carrer Rector Francisco Revert"					
"Calle Fernando El Católico"	"Carrer Ferran el Catòlic"					
"Calle Joaquín Sorolla"	"Carrer Joaquín Sorolla"					
"Calle Manuel Brosseta"	"Carrer Manuel Brosseta"					
"Calle Miquel Grau"	"Carrer Miquel Grau"					
"Calle Sor Angela de la Cruz"	"Carrer Sor Ángela de la Cruz"					
"Calle San Pío X"	"Carrer Sant Pius X"					
"Calle de la Santa Cruz"	"Carrer de la Santa Creu"					
"Calle Ricard Fuster i Fuster"	"Carrer Ricard Fuster i Fuster"					
"Calle Camí del Dijous"	"Carrer Camí del Dijous"					
"Calle de Benito Montalt Martínez"	"Carrer de Benito Montalt Martínez"					
"Calle Genaro Taberner"	"Carrer Genaro Taberner"					
"Calle del Colegio"	"Carrer del Col·legi"					
"Calle del Arte Mayor de la Seda"	"Carrer de l’Art Major de la Seda"					
"Calle de San Ramón"	"Carrer de Sant Ramon"					
"Calle Matilde Salvador"	"Carrer Matilde Salvador"					
"Calle de Montemayor"	"Carrer de Montemayor"					
"Calle Isabel de Villena"	"Carrer Isabel de Villena"					
"Calle Jaume Roig"	"Carrer Jaume Roig"					
"Calle Rigoberta Menchu"	"Carrer Rigoberta Menchu"					
"Calle de Vicente Casabán Sena"	"Carrer de Vicente Casabán Sena"					
"Calle Número 15"	"Carrer 15"					
"Calle de Montesa"	"Carrer de Montesa"					
"Calle Polideportivo"	"Carrer Poliesportiu"					
"Calle Cantalobos"	"Carrer Cantallops"					
"Calle San Antonio"	"Carrer Sant Antoni"					
"Calle de José Iturbi"	"Carrer de José Iturbi"					
"Calle del Ángel del Alcázar"	"Carrer del Molí"					
"Calle Salvador Torrent"	"Carrer Salvador Torrent"					
"Calle de Juan Molina"	"Carrer de Juan Molina"					
"Calle del Rey Don Jaime"	"Carrer del Rei en Jaume"					
"Calle de San Antonio"	"Carrer de Sant Antoni"					
"Calle del Maestro Rodrigo"	"Carrer del Mestre Rodrigo"					
"Calle de la Diputación"	"Carrer de la Diputació"					
"Calle de San Vicente Ferrer"	"Carrer de Sant Vicent Ferrer"					
"Calle de la Parreta"	"Carrer de la Parreta"					
"Calle de Sacramento Esteve"	"Carrer de Sacramento Esteve"					
"Calle de la Virgen de la Salud"	"Carrer de la Mare de Déu de la Salut"					
"Calle de San Miguel"	"Carrer de Sant Miquel"					
"Calle Maestro"	"Carrer Mestre"					
"Calle del Dos de Mayo"	"Carrer del Dos de Maig"					
"Calle del Doctor Moliner"	"Carrer del Doctor Moliner"					
"Calle de la Estrella"	"Carrer de l’Estrella"					
"Calle de Pérez Galdós"	"Carrer de Pérez Galdós"					
"Calle Germans Conejero Tomás"	"Carrer Germans Conejero Tomás"					
"Calle Número 13"	"Carrer 13"					
"Calle Paiporta"	"Carrer Paiporta"					
"Calle de Salvador Castillo"	"Carrer de Salvador Castillo"					
"Calle del Maestro Serrano"	"Carrer del Mestre Serrano"					
"Calle de Mislata"	"Carrer de Mislata"					
"Calle del Molí"	"Carrer del Molí"					
"Calle de Vicente Lladró Sena"	"Carrer de Vicente Lladró Sena"					
"Calle de Joaquín Orero"	"Carrer de Joaquín Orero"					
"Calle Perenxisa"	"Carrer Perenxisa"					
"Calle de Sierra de Espadá"	"Carrer de Serra d’Espadà"					
"Calle de Sierra de Aitana"	"Carrer de Serra d’Aitana"					
"Calle Montcabrer"	"Carrer Montcabrer"					
"Calle Montuber"	"Carrer Mondúver"					
"Calle de Villarrobledo"	"Carrer de Villarrobledo"					
"Calle de Ciudad Real"	"Carrer de Ciudad Real"					
"Calle Peñón de Ifach"	"Carrer Penyal d’Ifac"					
"Calle de Motilla"	"Carrer de Motilla"					
"Calle de la Salud"	"Carrer de la Salut"					
"Calle de Albacete"	"Carrer d’Albacete"					
"Calle de Don Juan de Austria"	"Carrer d’en Joan d’Àustria"					
"Calle de Isabel la Católica"	"Carrer d’Isabel la Catòlica"					
"Calle de Primero de Mayo"	"Carrer del Primer de Maig"					
"Calle de Vicente Aleixandre"	"Carrer de Vicente Aleixandre"					
"Calle de Minglanilla"	"Carrer de Minglanilla"					
"Calle de Pintor Segrelles"	"Carrer de Pintor Segrelles"					
"Calle de la Libertad"	"Carrer de la Llibertat"					
"Calle de Burriana"	"Carrer de Borriana"					
"Calle de Arcos de los Naranjos"						
"Calle de la Unión"	"Carrer de la Unió"					
"Calle de Albarracín"	"Carrer d’Albarracín"					
"Calle de Núñez de Balboa"	"Carrer de Núñez de Balboa"					
"Calle de Marconi"	"Carrer de Marconi"					
"Calle de Gibraltar"	"Carrer de Gibraltar"					
"Calle Pere el Cermoniós"	"Carrer Pere el Cerimoniós"					
"Calle de Martín el Humano"	"Carrer de Martí l’Humà"					
"Calle de los Reyes Católicos"	"Carrer dels Reis Catòlics"					
"Calle Cheste"	"Carrer de Xest"					
"Calle Molineta"	"Carrer Molineta"					
"Calle Chiva"	"Carrer de Xiva"					
"Calle de Pablo Picasso"	"Carrer de Pablo Picasso"					
"Calle del Medio"	"Carrer del Mig"					
"Calle de Jorge Guillén"	"Carrer de Jorge Guillén"					
"Calle Dos de Mayo"	"Carrer Dos de Maig"					
"Calle Industria"	"Carrer Indústria"					
"Calle Solidaridad"	"Carrer Solidaritat"					
"Calle Aldaia"	"Carrer Aldaia"					
"Calle de la Música"	"Carrer de la Música"					
"Calle de la Hermita de San Onofre"	"Carrer de l’Ermita de Sant Onofre"					
"Calle de San Pedro"	"Carrer de Sant Pere"					
"Calle de la Cautiva"	"Carrer de la Captiva"					
"Calle de Vicente Blasco Ibáñez"	"Carrer de Vicente Blasco Ibáñez"					
"Calle del Obispo Pildain"	"Carrer del Bisbe Pildain"					
"Calle de Cuenca"	"Carrer de Conca"					
"Calle de Alaquas"	"Carrer d’Alaquàs"					
"Calle de Requena"	"Carrer de Requena"					
"Calle de Burjasot"	"Carrer de Burjassot"					
"Calle del Maestro Guillem"	"Carrer del Mestre Guillem"					
"Calle de Santa Florentina"	"Carrer de Santa Florentina"					
"Calle de Monseñor de Aviñón"	"Carrer de Monsenyor d’Avinyó"					
"Calle del Reverendo Francisco Castelló Gil"	"Carrer del Reverend Francisco Castelló Gil"					
"Calle de Quart"	"Carrer de Quart"					
"Calle de Murillo"	"Carrer de Murillo"					
"Calle de Pizarro"	"Carrer de Pizarro"					
"Calle de la Aviación"	"Carrer de l’Aviació"					
"Calle de Nocedal"	"Carrer de Nocedal"					
"Calle de Sierpes"	"Carrer de Sierpes"					
"Calle del Cementerio"	"Carrer del Cementeri"					
"Calle del General Castaños"	"Carrer del General Castaños"					
"Calle José María Verdejo"	"Carrer José María Verdejo"					
"Calle del Maestro Guerrero"	"Carrer del Mestre Guerrero"					
"Calle del Maestro Bretón"	"Carrer del Mestre Bretón"					
"Calle de Francisco Valldecabres"	"Carrer de Francisco Valldecabres"					
"Calle de José Casanova"	"Carrer de José Casanova"					
"Calle de Ausias March"	"Carrer d’Ausiàs March"					
"Calle de Miguel Suria"	"Carrer de Miguel Suria"					
"Calle Escalante"	"Carrer Escalante"					
"Calle de la Campana"	"Carrer de la Campana"					
"Calle de Fermín Vilar"	"Carrer de Fermín Vilar"					
"Calle de Santa Teresa de Jesús"	"Carrer de Santa Teresa de Jesús"					
"Calle Pascual Esteve Miquel"	"Carrer Pascual Esteve Miquel"					
"Calle de las Rosas"	"Carrer de les Roses"					
"Calle Terrisser"	"Carrer Terrisser"					
"Calle Arturo Almar"	"Carrer Arturo Almar"					
"Calle Doctor Enrique Gargallo"	"Carrer Doctor Enrique Gargallo"					
"Calle San Edesio"	"Carrer Sant Edesi"					
"Calle del Campo de la Olivereta"	"Carrer del Camp de l’Olivereta"					
"Calle Olivo"	"Carrer Olivera"					
"Calle de Rodrigo Botet"	"Carrer de Rodrigo Botet"					
"Calle de los Santos Justo y Pastor"	"Carrer dels Sants Just i Pastor"					
"Calle de Balmes"	"Carrer de Balmes"					
"Calle de Olivereta"	"Carrer de l’Olivereta"					
"Calle José María Carpintero Alpuente"	"Carrer José María Carpintero Alpuente"					
"Calle de Juan de la Cierva"	"Carrer de Juan de la Cierva"					
"Calle Ceramista Marcial Marco"	"Carrer Ceramista Marcial Marco"					
"Calle Constantí Gómez Reig"	"Carrer Constantí Gómez Reig"					
"Calle de la Viña"	"Carrer de la Vinya"					
"Calle de la Traslación"	"Carrer de la Translació"					
"Calle del Oeste"	"Carrer de l’Oest"					
"Calle Aitana"	"Carrer Aitana"					
"Calle Manuel Montoro García"	"Carrer Manuel Montoro García"					
"Calle de la Virgen de la Soledad"	"Carrer de la Mare de Déu de la Soletat"					
"Calle de la Masía de la Cova"	"Carrer de la Masia de la Cova"					
"Calle del Cura Catalá"	"Carrer del Cura Català"					
"Calle del Pilaret"	"Carrer del Pilaret"					
"Calle de San Bernardo"	"Carrer de Sant Bernat"					
"Calle Maestro Palau"	"Carrer Mestre Palau"					
"Calle Amalia Mayo i Albert"	"Carrer Amalia Mayo i Albert"					
"Calle Bandera Valenciana"	"Carrer Bandera Valenciana"					
"Calle del Mediodía"	"Carrer del Migdia"					
"Calle Ceramista Mora Rives"	"Carrer Ceramista Mora Rives"					
"Calle de las Germanías"	"Carrer de les Germanies"					
"Calle de Menéndez Pelayo"	"Carrer de Menéndez Pelayo"					
"Calle del Geranio"	"Carrer del Gerani"					
"Calle del Maestro Chapí"	"Carrer del Mestre Chapí"					
"Calle Arcipreste Granell"	"Carrer Arxipreste Granell"					
"Calle de la Acequia"	"Carrer de la Séquia"					
"Calle de la Escalera"	"Carrer de les Escales"					
"Calle Bomba"	"Carrer Bomba"					
"Calle de García Lorca"	"Carrer de García Lorca"					
"Calle Compañía"	"Carrer Companyia"					
"Calle Pitera"	"Carrer Pitera"					
"Calle Cánovas del Castillo"	"Carrer Cánovas del Castillo"					
"Calle Guillem de Castro"	"Carrer Guillem de Castro"					
"Calle Rinconada"	"Carrer Rinconada"					
"Calle Fotógrafo José Gadea"	"Carrer Fotògraf José Gadea"					
"Calle de Manuel Vilar"	"Carrer de Manuel Vilar"					
"Calle de San Cayetano"	"Carrer de Sant Gaietà"					
"Calle de Manuel de Falla"	"Carrer de Manuel de Falla"					
"Calle de Félix Pizcueta"	"Carrer de Félix Pizcueta"					
"Calle de Justo Villar"	"Carrer de Justo Villar"					
"Calle de Félix Vilar"	"Carrer de Félix Vilar"					
"Calle del Río Cérvol"	"Carrer del Riu Cervol"					
"Calle Blas de Otero"	"Carrer Blas de Otero"					
"Calle de Don Crescencio Rodilla"	"Carrer de Don Crescencio Rodilla"					
"Calle del Palleter"	"Carrer del Palleter"					
"Calle de Vicente Vilar"	"Carrer de Vicente Vilar"					
"Calle del Hort"	"Carrer de l’Hort"					
"Calle de los Obradores"	"Carrer dels Obradors"					
"Calle del Doctor Peset Alexandre"	"Carrer del Doctor Peset Alexandre"					
"Calle del Río Serpis"	"Carrer del Riu Serpis"					
"Calle del Clavel"	"Carrer del Clavell"					
"Calle de Paterna"	"Carrer de Paterna"					
"Calle del Río Millares"	"Carrer del Riu Millars"					
"Calle de José Vilar"	"Carrer de José Vilar"					
"Calle de Rafael Valls"	"Carrer de Rafael Valls"					
"Calle del Montepío"	"Carrer del Montepío"					
"Calle del Cermista Gimeno"	"Carrer del Ceramista Gimeno"					
"Calle Fábricas"	"Carrer Fàbriques"					
"Calle En Bou"	"Carrer d’en Bou"					
"Calle de Olivar"	"Carrer de l’Olivar"					
"Calle Mosen Pere Espluges"	"Carrer Mossén Pere Espluges"					
"Calle Angel"	"Carrer de l’Àngel"					
"Calle Doctor José Catalá"	"Carrer Doctor José Catalá"					
"Calle del Sagrario"	"Carrer del Sagrari"					
"Calle del Obispo Soler"	"Carrer del Bisbe Soler"					
"Calle Mariano Benlliure"	"Carrer Mariano Benlliure"					
"Calle de San Edesio"	"Carrer de Sant Edesi"					
"Calle Constitución"	"Carrer Constitució"					
"Calle Gabriel López Catalá"	"Carrer Gabriel López Catalá"					
"Calle Vicente Navarro Arnal"	"Carrer Vicente Navarro Arnal"					
"Calle Escultor Octavio Vicent"	"Carrer Escultor Octavio Vicent"					
"Calle Onofre Sanmartín Rodrigo"	"Carrer Onofre Sanmartín Rodrigo"					
"Calles Santa Justa y Rufina"	"Calles Santa Justa i Rufina"					
"Calle Barrio Cuevas"						
"Calle San Pascual"	"Carrer Sant Pasqual"					
"Calle Santa Félix"	"Carrer Santa Fèlix"					
"Calle Vegas"	"Carrer Vegas"					
"Calle de la Bajada del Río"	"Carrer de la Baixada del Riu"					
"Calle Músico Morató"	"Carrer Músic Morató"					
"Calle Pintor Domingo"	"Carrer Pintor Domingo"					
"Calle de San Juan"	"Carrer de Sant Joan"					
"Calle Pozo"	"Carrer del Pou"					
"Calle Isabel la Católica"	"Carrer Isabel la Catòlica"					
"Calle Benavente"	"Carrer Benavente"					
"Calle Cisterna"	"Carrer Cisterna"					
"Calle de Sanchis Royo"	"Carrer de Sanchis Royo"					
"Calle de José María Jorge Coll"	"Carrer de José María Jorge Coll"					
"Calle Final"	"Carrer Final"					
"Calle Veinticinco de Abril"	"Carrer Vint-i-cinc d’Abril"					
"Calle del Doctor Mora Sanz"	"Carrer del Doctor Mora Sanz"					
"Calle Quart de Poblet"	"Carrer Quart de Poblet"					
"Calle Doctor Machi"	"Carrer Doctor Machi"					
"Calle Campanar"	"Carrer Campanar"					
"Calle del Verderol"	"Carrer del Verderol"					
"Calle de Teuladí"	"Carrer del Teuladí"					
"Calle del Rossinyol"	"Carrer del Rossinyol"					
"Calle de Oriol"	"Carrer de l’Oriol"					
"Calle de la Marina Alta"	"Carrer de la Marina Alta"					
"Calle del Comtat"	"Carrer del Comtat"					
"Calle de l'Alcalatén"	"Carrer de l'Alcalatén"					
"Calle de l'Alcoià"	"Carrer de l'Alcoià"					
"Calle dels Ports"	"Carrer dels Ports"					
"Calle de Plana Alta"	"Carrer de la Plana Alta"					
"Calle de la Canal de Navarrés"	"Carrer de la Canal de Navarrés"					
"Calle Vent del Nord"	"Carrer del Vent del Nord"					
"Calle Vent de Ponent"	"Carrer del Vent de Ponent"					
"Calle Vent de Tramuntana"	"Carrer del Vent de Tramuntana"					
"Calle de la Garrofera"	"Carrer de la Garrofera"					
"Calle del Gerani"	"Carrer del Gerani"					
"Calle del Trévol"	"Carrer del Trèvol"					
"Calle de la Sempreviva"	"Carrer de la Sempreviva"					
"Calle del Barranco Rubio"	"Carrer del Barranc Rúbio"					
"Calle del Codonyer"	"Carrer del Codonyer"					
"Calle del Cirerer"	"Carrer del Cirerer"					
"Calle Ametler"	"Carrer de l’Ametler"					
"Calle de l'Horta"	"Carrer de l'Horta"					
"Calle de Penáguila"	"Carrer de Penàguila"					
"Calle del Camp de Morvedre"	"Carrer del Camp de Morvedre"					
"Calle de la Hoya de Buñol"	"Carrer de la Foia de Bunyol"					
"Calle de Sueca"	"Carrer de Sueca"					
"Calle del Alto Turia"	"Carrer de l’Alt Túria"					
"Calle de la Ribera"	"Carrer de la Ribera"					
"Calle del Baix Vinalopó"	"Carrer del Baix Vinalopó"					
"Calle de Peñagolosa"	"Carrer de Penyagolosa"					
"Calle Ciudad de Barcelona"	"Carrer de la Ciutat de Barcelona"					
"Calle Barranco de Serra"	"Carrer del Barranc de Serra"					
"Calle Ciudad de Gibrartar"	"Carrer de la Ciutat de Gibrartar"					
"Calle Onteniente"	"Carrer d’Ontinyent"					
"Calle Ciudad de Cartagena"	"Carrer de la Ciutat de Cartagena"					
"Calle Villa de Bilbao"	"Carrer de la Vil·la de Bilbao"					
"Calle Ciudad de Eibar"	"Carrer de la Ciutat d’Eibar"					
"Calle Ciudad del Ferrol"	"Carrer de la Ciutat de Ferrol"					
"Calle Islas Canarias"	"Carrer Illes Canàries"					
"Calle Mijares"	"Carrer del Millars"					
"Calle María Auxiliadora"	"Carrer de Maria Auxiliadora"					
"Calle de Nicolás David"	"Carrer de Nicolás David"					
"Calle Francesc Ferrer Pastor"	"Carrer de Francesc Ferrer Pastor"					
"Calle Francisco Mateu Pérez"	"Carrer de Francisco Mateu Pérez"					
"Calle de Palafox"	"Carrer de Palafox"					
"Calle Juan Pablo II"	"Carrer de Joan Pau II"					
"Calle Mallent i Meri"	"Carrer de Mallent i Meri"					
"Calle Rabosar"	"Carrer Rabosar"					
"Calle Labradores"	"Carrer dels Llauradors"					
"Calle Manises"	"Carrer de Manises"					
"Calle Benimar"	"Carrer de Benimar"					
"Calle de los Molinos"	"Carrer dels Molins"					
"Calle del Testar"	"Carrer del Testar"					
"Calle Els Blanquers"	"Carrer dels Blanquers"					
"Calle Melias"	"Carrer de les Mèlies"					
"Calle Terrissers"	"Carrer dels Terrissers"					
"Calle Beniopa"	"Carrer de Beniopa"					
"Calle San Onofre"	"Carrer de Sant Onofre"					
"Calle del Palmar"	"Carrer del Palmar"					
"Calle Barranco del Sauce"	"Carrer Barranquet del Sau"					
"Calle Villa de Madrid"	"Carrer de la Vil·la de Madrid"					
"Calle Ciudad de Elda"	"Carrer de la Ciutat d’Elda"					
"Calle Ciudad de Sevilla"	"Carrer de la Ciutat de Sevilla"					
"Calle Ciudad de Sagunto"	"Carrer de la Ciutat de Sagunt"					
"Calle Ciudad de Alcoy"	"Carrer de la Ciutat d’Alcoi"					
"Calle Ciudad de Onda"	"Carrer de la Ciutat d’Onda"					
"Calle Manya"	"Carrer del Manyà"					
"Calle Llanterner"	"Carrer del Llanterner"					
"Calle Fuster"	"Carrer del Fuster"					
"Calle de Algepser"	"Carrer de l’Algepser"					
"Calle Velluter"	"Carrer dels Velluters"					
"Calle de la Ciudad de Liria"	"Carrer de la Ciutat de Llíria"					
"Calle Vall d'Uxó"	"Carrer de la Vall d'Uixó"					
"Calle de les Ones"	"Carrer de les Ones"					
"Calle Gavines"	"Carrer de les Gavines"					
"Calle Miguel Adlert i Noguerol"	"Carrer Miguel Adlert i Noguerol"					
"Calle Carrasca"	"Carrer Carrasca"					
"Calle Freixe"	"Carrer Freixe"					
"Calle Savina"	"Carrer Savina"					
"Calle Coeters"	"Carrer dels Coeters"					
"Calle Pintors"	"Carrer Pintors"					
"Calle Botiguers"	"Carrer Botiguers"					
"Calle Correjer"	"Carrer Corretger"					
"Calle Oller"	"Carrer Oller"					
"Calle Vicente Cardona"	"Carrer Vicente Cardona"					
"Calle Juan Bautista Benlloch Gascó"	"Carrer Juan Bautista Benlloch Gascó"					
"Calle Domingo Belenguer"	"Carrer Domingo Belenguer"					
"Calle Canalejas"	"Carrer Canalejas"					
"Calle Pintor Vicente Borrás"	"Carrer Pintor Vicente Borrás"					
"Calle General Palafox"	"Carrer General Palafox"					
"Calle Pintor Pablo Ruiz Picasso"	"Carrer Pintor Pablo Ruiz Picasso"					
"Calle General Gil Dolz"	"Carrer General Gil Dolz"					
"Calle General Cialdini"	"Carrer General Cialdini"					
"Calle General Moltó"	"Carrer General Moltó"					
"Calle Cuevas del Batán"	"Carrer Coves del Batà"					
"Calle Cardenal Benlloch"	"Carrer Cardenal Benlloch"					
"Calle San Pascual Bailón"	"Carrer Sant Pasqual Bailón"					
"Calle Alborgí"	"Carrer de l’Alborgí"					
"Calle Eduardo Dato"	"Carrer d’Eduardo Dato"					
"Calle del Polígono Norte"	"Carrer del Polígon Nord"					
"Calle San Miguel Arcángel"	"Carrer Sant Miquel Arcàngel"					
"Calle Maestro Ramón Ramia Querol"	"Carrer Mestre Ramón Ramia Querol"					
"Calle Maestra Doña Mariana Colás"	"Carrer Mestra Doña Mariana Colás"					
"Calle Aldaya"	"Carrer Aldaia"					
"Calle Ribera"	"Carrer Ribera"					
"Calle La Torre"	"Carrer de la Torre"					
"Calle de Bétera"	"Carrer de Bétera"					
"Calle Teniente Alfonso"	"Carrer Tinent Alfonso"					
"Calle Benissano"	"Carrer Benissanó"					
"Calle Camino de Godella"	"Carrer Camino de Godella"					
"Calle de Ibi"	"Carrer d’Ibi"					
"Calle de l'Alcora"	"Carrer de l'Alcora"					
"Calle de Alginet"	"Carrer d’Alginet"					
"Calle de Almenara"	"Carrer d’Almenara"					
"Calle Utiel"	"Carrer Utiel"					
"Calle de Casinos"	"Carrer de Casinos"					
"Calle Ronda"	"Carrer Ronda"					
"Calle Cuiners"	"Carrer Cuiners"					
"Calle del Tomillo"	"Carrer del Tomell"					
"Calle del Llentiscle"	"Carrer del Llentiscle"					
"Calle Ortiga"	"Carrer Ortiga"					
"Calle de la Falaguera"	"Carrer de la Falaguera"					
"Calle del Espígol"	"Carrer de l’Espígol"					
"Calle del Llicsó"	"Carrer del Llicsó"					
"Calle de la Melisa"	"Carrer de la Melissa"					
"Calle de Carcaixent"	"Carrer de Carcaixent"					
"Calle de la Ginesta"	"Carrer de la Ginesta"					
"Calle de la Malva"	"Carrer de la Malva"					
"Calle de Catí"	"Carrer de Catí"					
"Calle del Ravanell"	"Carrer del Ravanell"					
"Calle Fenoll"	"Carrer Fenoll"					
"Calle de la Frigola"	"Carrer de la Frigola"					
"Calle de Carlina"	"Carrer de Carlina"					
"Calle de la Duradella"	"Carrer de la Dauradella"					
"Calle Plantatge"	"Carrer Plantatge"					
"Calle de la Alfábega"	"Carrer de l’Alfàbega"					
"Calle de la Camomila"	"Carrer de la Camamilla"					
"Calle de Carlos Ferris Vila"	"Carrer de Carlos Ferris Vila"					
"Calle Catedrático Agustín Escardino Benlloch"	"Carrer Catedràtic Agustín Escardino Benlloch"					
"Calle Rocafort"	"Carrer Rocafort"					
"Calle de Santa Aurora"	"Carrer de Santa Aurora"					
"Calle de Rafael Alberti"	"Carrer de Rafael Alberti"					
"Calle Barri el Trencall"	"Carrer Barri el Trencall"					
"Calle Catedrático José Beltrán"	"Carrer Catedràtic José Beltrán"					
"Calle Poeta Agustín Goytisolo"	"Carrer Poeta Agustín Goytisolo"					
"Calle de San Valero"	"Carrer de Sant Valero"					
"Calle Poeta Vicente Andrés Estellés"	"Carrer Poeta Vicent Andrés Estellés"					
"Calle de Santa Gema"	"Carrer de Santa Gemma"					
"Calle de la Automoción"	"Carrer de l’Automoció"					
"Calle de las Energías Renovables"	"Carrer de les Energies Renovables"					
"Calle del Comercio"	"Carrer del Comerç"					
"Calle de las Nuevas Tecnologías"	"Carrer de les Noves Tecnologies"					
"Calle de la Metalurgia"	"Carrer de la Metal·lúrgia"					
"Calle de Pinaeta"	"Carrer de Pinaeta"					
"Calle de Pi Panera"	"Carrer de Pi Panera"					
"Calle de Sierra de Agullent"	"Carrer de la Serra d’Agullent"					
"Calle de Sierra de Ombría"	"Carrer de la Serra de l’Ombria"					
"Calle de Guillem Tatay"	"Carrer de Guillem Tatay"					
"Calle del Fundador"	"Carrer del Fundador"					
"Calle Palmeras"	"Carrer Palmeres"					
"Calle Nísperos"	"Carrer Nispros"					
"Calle de Llendoners Almez"	"Carrer de Llendoners Almez"					
"Calle de los Cerezos"						
"Calle de Puigcampana"	"Carrer de Puigcampana"					
"Calle de Montmajor"	"Carrer de Montmajor"					
"Calle del Montgó"	"Carrer del Montgó"					
"Calle de los Nogales"						
"Calle Llendoners Almez"	"Carrer Lledoners"					
"Calle de Sierra de Bernia"	"Carrer de la Serra de Bèrnia"					
"Calle de Alboraya"	"Carrer d’Alboraia"					
"Calle de Albal"	"Carrer d'Albal"					
"Calle de la Sierra de Javalambre"	"Carrer de la Serra de Javalambre"					
"Calle Sierra de Crevillente"	"Carrer de la Serra de Crevillent"					
"Calle de Sierra Mariola"	"Carrer de la Serra Mariola"					
"Calle de les Pruneres"	"Carrer de les Pruneres"					
"Calle Rafel el Gallo"	"Carrer Rafel el Gallo"					
"Calle del Primero de Mayo"	"Carrer del Primer de Maig"					
"Calle de Rafael el Gallo"	"Carrer de Rafael el Gallo"					
"Calle de Félix Rodríguez de la Fuente"	"Carrer de Félix Rodríguez de la Fuente"					
"Calle de Juan Bautista Comes"	"Carrer de Juan Bautista Comes"					
"Calle Jardín Alquería Nova"	"Carrer del Jardí de l’Alqueria Nova"					
"Calle de Santo Domingo de Guzmán"	"Carrer de Sant Domènec de Guzmán"					
