"name"	"name:ca"	"alt_name:ca"	"alt_name"	"translations"	"ca.wikipedia_page"	"wikidata_id"
"Parque Juvenil"	"Parc Juvenil"					
"Parque infantil"	"Parc infantil"					
"Parque la rueda de piedra"	"Parc la rueda de piedra"					
"Parque juvenil"	"Parc juvenil"					
"Parque temàtico de las Brujas de Laspaúls"	"Parc temàtico de las Brujas de Laspaúls"					
"parque de fernando aranda"	"parc de fernando aranda"					
"parque verde"	"parc verde"					
"parque del patrocinio"	"parc del patrocinio"					
"parque de la iglesia"	"parc de la iglesia"					
"parque de la calle san miguel"	"parc de la calle san miguel"					
"parque con un tobogan"	"parc con un tobogan"					
"parque con cancha de basket"	"parc con cancha de basket"					
"parque de la guarderia"	"parc de la guarderia"					
"parque de la roca de la botella"	"parc de la roca de la botella"					
"parque en albelda"	"parc en albelda"					
"Parque de las Badinas"	"Parc de las Badinas"					
"Parque del Río Cinca"	"Parc del Río Cinca"					
"Parque de los Olivos"	"Parc de los Olivos"					
"Parque de los Olivos II"	"Parc de los Olivos II"					
"Parque de los Olivos III"	"Parc de los Olivos III"					
"Parque Hangar"	"Parc Hangar"					
"Parque del Castillo Ciudad de Fraga"	"Parc del Castillo Ciudad de Fraga"					
"Parque Mar"	"Parc Mar"					
"Parque Maioris"	"Parc Maioris"					
"Parque infaltin Jovellanos"	"Parc infaltin Jovellanos"					
"Parque Son Muntaner"	"Parc Son Muntaner"					
"Parque Son Roqueta"	"Parc Son Roqueta"					
"Parque en Son Moix"	"Parc en Son Moix"					
"Parque de San Pau"	"Parc de San Pau"					
"Parque Casal de Barri Son Cotoner"	"Parc Casal de Barri Son Cotoner"					
"Parque Infantil"	"Parc Infantil"					
"Parque Son Peretó"	"Parc Son Peretó"					
"Parque Sor Catalina Maura"	"Parc Sor Catalina Maura"					
"Parquet Balears"	"Parquet Balears"					
"Parque Centro Comercial FAN"	"Parc Centro Comercial FAN"					
"Parque de los dinosaurios"	"Parc de los dinosaurios"					
"Parque Mar d'Aral"	"Parc Mar d'Aral"					
"Parque solar Huerto Son Falconer"	"Parc solar Huerto Son Falconer"					
"Parque Pollença Sur"	"Parc Pollença Sur"					
"Parque Pollença Norte"	"Parc Pollença Norte"					
"Parque Ca les Munnares"	"Parc Ca les Munnares"					
"Parque de calistenia"	"Parc de calistenia"					
"Parque Infantil de Pollença"	"Parc Infantil de Pollença"					
"Parque Plaza Ca les Munnares"	"Parc Plaza Ca les Munnares"					
"Parque Ca Les Munnares"	"Parc Ca Les Munnares"					
"Parque sur Ca les Munnares"	"Parc sur Ca les Munnares"					
"Parque Municipal Son Bauló"	"Parc Municipal Son Bauló"					
"parquet Manacor"	"parquet Manacor"					
"Parque Nereida"	"Parc Nereida"					
"Parque Polideportivo"	"Parc Polideportivo"					
"Parque Es Cubells"	"Parc Es Cubells"					
"Parque Acuático Aguamar"	"Parc Acuático Aguamar"					
"Parquecito"	"Parquecito"					
"Parque infantil S´illa"	"Parc infantil S´illa"					
"Parque"	"Parque"					
"Parque Sant Josep"	"Parc Sant Josep"					
"Parque infantil Plaça d'Espanya"	"Parc infantil Plaça d'Espanya"					
"Parque de los Pinos"	"Parc de los Pinos"					
"Parque de Jesús"	"Parc de Jesús"					
"parque"	"parque"					
"Parque de verano"	"Parc de verano"					
"Parque de la fuente"	"Parc de la fuente"					
"Parque Minigolf"	"Parc Minigolf"					
"Parque Infantil Hotel"	"Parc Infantil Hotel"					
"Parque Canutells"	"Parc Canutells"					
"Parque con pistas deportivas"	"Parc con pistas deportivas"					
"Parque solar de Binisafúller"	"Parc solar de Binisafúller"					
"Parque Publico San Sivina"	"Parc Publico San Sivina"					
"Parque Verdager"	"Parc Verdager"					
"Parque Son Expedito"	"Parc Son Expedito"					
"Parque de la concha"	"Parc de la concha"					
"Parque Acuático Marina Parc"	"Parc Acuático Marina Parc"					
"Parque de San Clemente"	"Parc de San Clemente"					
"Parque Ses Vinyes"	"Parc Ses Vinyes"					
"Parque \"Es Freginal\""	"Parc \"Es Freginal\""					
"Parque Cardenal Vives"	"Parc Cardenal Vives"					
"Parque del Monumento"	"Parc del Monumento"					
"Parque Municipal"	"Parc Municipal"					
"Parque con teatro al aire libre"	"Parc con teatro al aire libre"					
"Parque del Grand Prix"	"Parc del Grand Prix"					
"Parque La Sardana"	"Parc La Sardana"					
"Parque Can Mir 1"	"Parc Can Mir 1"					
"Parque de la Inercia"	"Parc de la Inercia"					
"parque del castell"	"parc del castell"					
"Parque Santa Fe"	"Parc Santa Fe"					
"Parque Can Mir 5"	"Parc Can Mir 5"					
"Parque Castellnou 1"	"Parc Castellnou 1"					
"Parque de la carretera vella"	"Parc de la carretera vella"					
"Parque canino"	"Parc canino"					
"Parquet's Uriol"	"Parquet's Uriol"					
"Parquets i Paviments"	"Parquets i Paviments"					
"Parque Güell entradas"	"Parc Güell entradas"					
"Parque interior Camp d'en Grassot"	"Parc interior Camp d'en Grassot"					
"Parque de deportes"	"Parc de deportes"					
"Parque de deporte"	"Parc de deporte"					
"Parque, Área de descanso y Pic-Nic Passeig Fluvial"	"Parque, Área de descanso y Pic-Nic Passeig Fluvial"					
"Parque detras de la estacion"	"Parc detras de la estacion"					
"Parque Can Xerracan"	"Parc Can Xerracan"					
"Parque de Can Sauleda"	"Parc de Can Sauleda"					
"parque de la fuente"	"parc de la fuente"					
"Parque Eólico La Llacuna"	"Parc Eólico La Llacuna"					
"Parque para perros"	"Parc para perros"					
"Parque rambla sant just"	"Parc rambla sant just"					
"Parque de la Muntanyeta"	"Parc de la Muntanyeta"					
"Parque de Skate"	"Parc de Skate"					
"parque recreativo"	"parc recreativo"					
"Parque de la Olla"	"Parc de la Olla"					
"Parque Fatjò"	"Parc Fatjò"					
"Parque Infantil Mila"	"Parc Infantil Mila"					
"Parque Lluís Millet"	"Parc Lluís Millet"					
"Parque dels Capgrossos d'Esplgues"	"Parc dels Capgrossos d'Esplgues"					
"Parque escondido"	"Parc escondido"					
"Parque Sant Salvador"	"Parc Sant Salvador"					
"Parque patinaje plaça Catalunya"	"Parc patinaje plaça Catalunya"					
"Parque La Mallola"	"Parc La Mallola"					
"Parque de ocio infantil"	"Parc de ocio infantil"					
"parque los columpios"	"parc los columpios"					
"Parque Eólico Les Rotes"	"Parc Eólico Les Rotes"					
"Parque Eólico Sant Antoni II"	"Parc Eólico Sant Antoni II"					
"Parque Eólico Monclues"	"Parc Eólico Monclues"					
"Parque Eólico Sant Antoni I"	"Parc Eólico Sant Antoni I"					
"Parque Infantil Els Masos"	"Parc Infantil Els Masos"					
"Parque canino del Baix Llobregat"	"Parc canino del Baix Llobregat"					
"Parque Charlie River"	"Parc Charlie River"					
"Parque Infantil Les Clotes"	"Parc Infantil Les Clotes"					
"Parque de San Alejandro"	"Parc de San Alejandro"					
"Parque de San Juan Francisco"	"Parc de San Juan Francisco"					
"Parque del Final de la Riera"	"Parc del Final de la Riera"					
"Parque Salou"	"Parc Salou"					
"Parque de la vía Aurelia"	"Parc de la vía Aurelia"					
"Parque sensorial"	"Parc sensorial"					
"Parque de los pinos"	"Parc de los pinos"					
"Parque de la font"	"Parc de la font"					
"Parque Navas de Tolosa"	"Parc Navas de Tolosa"					
"Parque de la Estación de Tarragona"	"Parc de la Estación de Tarragona"					
"Parque Arcadia"	"Parc Arcadia"					
"Parque Eólico Fatallera"	"Parc Eólico Fatallera"					
"Parque Eólico Barbers"	"Parc Eólico Barbers"					
"Parque Eólico Coll de Moro"	"Parc Eólico Coll de Moro"					
"Parque Eólico Mudefer"	"Parc Eólico Mudefer"					
"Parque Eólico Vilalba del Arcs"	"Parc Eólico Vilalba del Arcs"					
"Parque Eólico Corbera"	"Parc Eólico Corbera"					
"Parque Eólico Vilalba"	"Parc Eólico Vilalba"					
"Parque Eólico Les Comes"	"Parc Eólico Les Comes"					
"Parque Plaza Dura"	"Parc Plaza Dura"					
"Parque Eólico Folch I"	"Parc Eólico Folch I"					
"Parque Eólico Arriello"	"Parc Eólico Arriello"					
"Parque de l'Estany"	"Parc de l'Estany"					
"Parque la carpa"	"Parc la carpa"					
"Parque del lago"	"Parc del lago"					
"Parque de Bomberos de Oropesa del Mar"	"Parc de Bomberos de Oropesa del Mar"					
"Parque Aquático"	"Parc Aquático"					
"Parque del Roselló"	"Parc del Roselló"					
"Parque Ciclista"	"Parc Ciclista"					
"Parque Sierra de Cazorla"	"Parc Sierra de Cazorla"					
"Parque de Santa Rosa"	"Parc de Santa Rosa"					
"Parque de Don Ramón James Boera"	"Parc de Don Ramón James Boera"					
"Parque de La Dolçaina i Tabalet"	"Parc de La Dolçaina i Tabalet"					
"Parque de San Lorenzo"	"Parc de San Lorenzo"					
"Parque del Chalet"	"Parc del Chalet"					
"Parque de Mérida"	"Parc de Mérida"					
"Parque del Maetro Luna"	"Parc del Maetro Luna"					
"Parque Rio Nilo"	"Parc Rio Nilo"					
"Parque Jardín Montesinos"	"Parc Jardín Montesinos"					
"Parque Antigua Corona de Aragón"	"Parc Antigua Corona de Aragón"					
"Parque polideportivo municipal juegos tradicionales \"El Boli\""	"Parc polideportivo municipal juegos tradicionales \"El Boli\""					
"Parque L'Olivaret"	"Parc L'Olivaret"					
"Parque de la Panderola"	"Parc de la Panderola"					
"Parque Público Canino"	"Parc Público Canino"					
"Parque Canino El Palmeral"	"Parc Canino El Palmeral"					
"Parque Juan XXIII"	"Parc Juan XXIII"					
"Parque de la Sierra de Mariola"	"Parc de la Sierra de Mariola"					
"Parque Vilamar"	"Parc Vilamar"					
"Parque playero Las Palmeras"	"Parc playero Las Palmeras"					
"Parque Infantil Gibraltar"	"Parc Infantil Gibraltar"					
"Parque de la Rotonda"	"Parc de la Rotonda"					
"Parque Infantil del Progreso"	"Parc Infantil del Progreso"					
"Parque de bomberos Espadá-Millars"	"Parc de bomberos Espadá-Millars"					
"Parque del Acueducto"	"Parc del Acueducto"					
"Parque urbano"	"Parc urbano"					
"Parque Comercial Cincovall"	"Parc Comercial Cincovall"					
"Parque de la Ermita"	"Parc de la Ermita"					
"Parque Ibn-Al Abbar"	"Parc Ibn-Al Abbar"					
"Parque de la Cerámica"	"Parc de la Cerámica"					
"Parque El Pla"	"Parc El Pla"					
"Parque del llorón"	"Parc del llorón"					
"Parque San Fernando"	"Parc San Fernando"					
"parque Cariñena"	"parc Cariñena"					
"parque Jaume I el Conqueridor"	"parc Jaume I el Conqueridor"					
"Parque Infantil Juevos Cariñena 2"	"Parc Infantil Juevos Cariñena 2"					
"Parque Infantil Juevos Cariñena"	"Parc Infantil Juevos Cariñena"					
"Parque de San Pascual"	"Parc de San Pascual"					
"Parque de Joaquín Vidal"	"Parc de Joaquín Vidal"					
"Parque del Ángel"	"Parc del Ángel"					
"parque carrer solades"	"parc carrer solades"					
"parque piscinas"	"parc piscinas"					
"parque calle Mallorca"	"parc calle Mallorca"					
"parque Pare Macet"	"parc Pare Macet"					
"Parque del pou"	"Parc del pou"					
"Parque Mayorazga"	"Parc Mayorazga"					
"Parque de educación vial"	"Parc de educación vial"					
"Parque industrial Ingruinsa"	"Parc industrial Ingruinsa"					
"Parque de Bomberos de Sagunto"	"Parc de Bomberos de Sagunto"					
"Parque del ambulatorio"	"Parc del ambulatorio"					
"Parque La Gerencia"	"Parc La Gerencia"					
"Parque El triangle"	"Parc El triangle"					
"Parque Plaza del Sol"	"Parc Plaza del Sol"					
"Parque Bomberos Zona II - Burjassot"	"Parc Bomberos Zona II - Burjassot"					
"Parque Jaime I"	"Parc Jaime I"					
"Parque Juana Maria Condesa Lluch"	"Parc Juana Maria Condesa Lluch"					
"Parque de Cantereria"	"Parc de Cantereria"					
"Parque Público Estación de Burjassot"	"Parc Público Estación de Burjassot"					
"Parque Escalante"	"Parc Escalante"					
"Parque El Colilla"	"Parc El Colilla"					
"Parque Vicente Ferrer"	"Parc Vicente Ferrer"					
"Parque La Llum"	"Parc La Llum"					
"parque la iglesia"	"parc la iglesia"					
"parque_iglesia"	"parque_iglesia"					
"Parque Emilio Ramon Llin"	"Parc Emilio Ramon Llin"					
"Parque de las vias"	"Parc de las vias"					
"Parque Plaza de la Cultura"	"Parc Plaza de la Cultura"					
"Parque Punt d'encontre"	"Parc Punt d'encontre"					
"Parque Ausiàs March"	"Parc Ausiàs March"					
"Parque Enrique Granados"	"Parc Enrique Granados"					
"Parque Granell"	"Parc Granell"					
"Parque Pinar"	"Parc Pinar"					
"Parque plaza de patinaje"	"Parc plaza de patinaje"					
"Parque infantil"	"Parc infantil"					""
"Parque niños"	"Parc niños"					""
"Parque de La Cañada"	"Parc de La Cañada"					""
"Parque infaltil"	"Parc infaltil"					""
"Parque Montelevante"	"Parc Montelevante"					""
"Parque de Reina Doña Sofía"	"Parc de Reina Doña Sofía"					""
"Parque Azorín"	"Parc Azorín"					""
"Parque del Perellonet"	"Parc del Perellonet"					""
"Parque Corts Valencianes"	"Parc Corts Valencianes"					""
"Parque del Moro"	"Parc del Moro"					""
"Parque Europa"	"Parc Europa"					""
"Parque de bomberos"	"Parc de bomberos"					""
"Parque Natural del Turia"	"Parc Natural del Turia"					""
"Parque de la Senyera"	"Parc de la Senyera"					""
"Parque"	"Parque"					""
"Parque del Che"	"Parc del Che"					""
"Parque Alqueria Nova"	"Parc Alqueria Nova"					""
"Parque Clara Campoamor"	"Parc Clara Campoamor"					""
"Parque Municipal Pablo Iglesias"	"Parc Municipal Pablo Iglesias"					""
"Parque Dolores Ibarruri"	"Parc Dolores Ibarruri"					""
"Parque Municipal 'Els Filtres'"	"Parc Municipal 'Els Filtres'"					""
"Parque Fluvial del Turia"	"Parc Fluvial del Turia"					""
"Parque Empresarial Táctica"	"Parc Empresarial Táctica"					""
"Parque de Bomberos de Paterna"	"Parc de Bomberos de Paterna"					""
"Parque Santo Cristo"	"Parc Santo Cristo"					""
"Parque Deposito de agua Fuente del Jarro"	"Parc Deposito de agua Fuente del Jarro"					""
"Parque PúblIco Jardines"	"Parc PúblIco Jardines"					""
"Parque de bolas"	"Parc de bolas"					""
"Parque Anatoli Karpoff"	"Parc Anatoli Karpoff"					""
"Parque de Lepanto"	"Parc de Lepanto"					""
"Parque Canino de Lepanto"	"Parc Canino de Lepanto"					""
"Parque de la Canaleta"	"Parc de la Canaleta"					"Q24024440"
"Parque Príncipe de Asturias"	"Parc Príncipe de Asturias"					""
"Parque de Paluzié"	"Parc de Paluzié"	""	""			
"Parque del Cementerio de Catarroja"	"Parc del Cementerio de Catarroja"	""	""			
"parque de delfos"	"parc de delfos"	""	""			
"Parque El Centenar"	"Parc El Centenar"	""	""			
"Parque Avenida del Mediterráneo"	"Parc Avenida del Mediterráneo"	""	""			
"parque de la petanca los alfalares"	"parc de la petanca los alfalares"	""	""			
"Parque Nou d'Octubre"	"Parc Nou d'Octubre"	""	""			
"Parque del Divendres"	"Parc del Divendres"	""	""			
"Parque infantil Font Cabilda"	"Parc infantil Font Cabilda"	""	""			
"parque del jubilado"	"parc del jubilado"	""	""			
"Parque Comercial Alfafar"	"Parc Comercial Alfafar"	""	""			
"parque de la oveja"	"parc de la oveja"	""	""			
"Parque de La Xapa"	"Parc de La Xapa"	""	""			
"Parque de Las Palmeras"	"Parc de Las Palmeras"	""	""			
"Parque La FIla"	"Parc La FIla"	""	""			
"Parque Adela Pla"	"Parc Adela Pla"	""	""			
"Parque Comercial Sedaví"	"Parc Comercial Sedaví"	"Centro Comercial Sedaví"	"Centro Comercial Sedaví"			
"Parque Plaza del Molino"	"Parc Plaza del Molino"	""	""			
"Parque Infantil Antonia Milán"	"Parc Infantil Antonia Milán"					
"Parque Rector Pesset Alexandre"	"Parc Rector Pesset Alexandre"					
"Parque Infantil \"Zona verda Joan Fuster\""	"Parc Infantil \"Zona verda Joan Fuster\""					
"Parque de San Antonio"	"Parc de San Antonio"					
"Parque de Bomberos - Cullera"	"Parc de Bomberos - Cullera"					
"Parque Bomberos Zona IV - Gandia"	"Parc Bomberos Zona IV - Gandia"	""	""			
"Parquecito de la caseta de luz"	"Parquecito de la caseta de luz"	""	""			
"Parque Infantil"	"Parc Infantil"	""	""			
"ParquenLocal"	"ParquenLocal"	""	""			
"Parque de Bomberos"	"Parc de Bomberos"	""	""			
"Parque de educación viaria"	"Parc de educación viaria"	""	""			
"Parque I"	"Parc I"	""	""			
"Parque II"	"Parc II"	""	""			
"Parque Avenida del litoral."	"Parc Avenida del litoral."	""	""			
"Parque de perros"	"Parc de perros"	""	""			
"Parque de la Glorieta"	"Parc de la Glorieta"	""	""			
"Parque de la Lonja"	"Parc de la Lonja"	""	""			
"Parque 2"	"Parc 2"	""	""			
"Parque Sant Jordi Fase Primera"	"Parc Sant Jordi Fase Primera"	""	""			
"Parque San Felipe"	"Parc San Felipe"	""	""			
"Parque Sant Jordi Fase Segunda"	"Parc Sant Jordi Fase Segunda"	""	""			
"Parque de Atracciones Gandilandia"	"Parc de Atracciones Gandilandia"	""	""			
"Parque 8"	"Parc 8"	""	""			
"Parque 7"	"Parc 7"	""	""			
"Parque 6"	"Parc 6"	""	""			
"Parque del Hotel Tres Anclas"	"Parc del Hotel Tres Anclas"	""	""			
"Parque Argut."	"Parc Argut."	""	""			
"Parque Aigua Blanca"	"Parc Aigua Blanca"	""	""			
"Parque de l'Almassera"	"Parc de l'Almassera"	""	""			
"Parque de la Font Gran"	"Parc de la Font Gran"	""	""			
"Parque del Riu Vaca"	"Parc del Riu Vaca"	""	""			
"Parque entrada de Xeraco"	"Parc entrada de Xeraco"	""	""			
"Parquemar V"	"Parquemar V"	"Parquemar 5"	"Parquemar 5"			
"Parquemar VIII"	"Parquemar VIII"	"Parquemar 8"	"Parquemar 8"			
"Parquemar III y IV"	"Parquemar III y IV"	""	""			
"Parquemar IV"	"Parquemar IV"	"Parquemar 4"	"Parquemar 4"			
"Parquemar"	"Parquemar"	""	""			
"Parque Derrota"	"Parc Derrota"					
"Parque Solar Alfarrasí"	"Parc Solar Alfarrasí"					
"Parque Solar Fotovoltaico La Garrofera"	"Parc Solar Fotovoltaico La Garrofera"					
"parque de la beata"	"parc de la beata"					
"parque de la merce"	"parc de la merce"					
"parque del espai jove"	"parc del espai jove"					
"parque infantil"	"parc infantil"					
"parque de la creu"	"parc de la creu"					
"parque de las ovejas"	"parc de las ovejas"					
"parque de la beata Inés"	"parc de la beata Inés"					
"parque del teular"	"parc del teular"					
"parque del taperal"	"parc del taperal"					
"Parque infantil El mundo de los niños"	"Parc infantil El mundo de los niños"			""	""	""
"Parque de Bolas"	"Parc de Bolas"			""	""	""
"parque Lo Morant"	"parc Lo Morant"			""	""	""
"Parque de las Avenidas"	"Parc de las Avenidas"			""	""	""
"Parque Comercial Vistahermosa"	"Parc Comercial Vistahermosa"			""	""	""
"Parque infantil"	"Parc infantil"			""	""	""
"Parque de Reciclado"	"Parc de Reciclado"			""	""	""
"Parque del Chalet del Ingeniero de Tranvías"	"Parc del Chalet del Ingeniero de Tranvías"			""	""	""
"Parque tráfico"	"Parc tráfico"			""	""	""
"Parque de la Ciudad de la Justicia"	"Parc de la Ciudad de la Justicia"			""	""	""
"Parque del Jardín Botánico"	"Parc del Jardín Botánico"			""	""	""
"Parque Cronista Enrique Cutillas"	"Parc Cronista Enrique Cutillas"			""	""	""
"Parque del Cronista Enrique Cutillas"	"Parc del Cronista Enrique Cutillas"			""	""	""
"Parque el Tossal"	"Parc el Tossal"			"Parc El Tossal, Parc Mont Tossal"	"Parc El Tossal"	"Q15617933"
"Parque del Doctor Rico"	"Parc del Doctor Rico"			""	""	""
"parque La Ereta"	"parc La Ereta"			""	""	""
"Parque Ilustrado"	"Parc Ilustrado"			""	""	""
"parque Lo Torrent"	"parc Lo Torrent"			""	""	"Q24003768"
"Parque Universidad"	"Parc Universidad"			""	""	""
"Parque Forestal Monte Orgegia"	"Parc Forestal Monte Orgegia"			""	""	""
"Parque Norte de Villafranqueza"	"Parc Norte de Villafranqueza"			""	""	""
"Parque María Auxiliadora"	"Parc María Auxiliadora"			""	""	""
"Parque Periodista Pepe Marin Guerrero"	"Parc Periodista Pepe Marin Guerrero"			""	""	""
"Parque Restaurador Vicente Mas"	"Parc Restaurador Vicente Mas"			""	""	""
"Parque Norte"	"Parc Norte"			""	""	""
"Parque Paraiso"	"Parc Paraiso"			""	""	""
"Parque Metropolitano Cabo de la Huerta"	"Parc Metropolitano Cabo de la Huerta"			""	""	""
"Parque de las Naciones"	"Parc de las Naciones"			""	""	""
"Parque de la Arqueóloga Solveig Nordström"	"Parc de la Arqueóloga Solveig Nordström"			""	""	""
"Parque Metropolitano Cabo Huertas"	"Parc Metropolitano Cabo Huertas"			""	""	""
"Parque de Bomberos"	"Parc de Bomberos"			""	""	""
"Parque Sergio Melgares"	"Parc Sergio Melgares"			""	""	""
"Parque Cristina"	"Parc Cristina"			""	""	""
"Parque de la Médica Manuela Pérez de Vekios"	"Parc de la Médica Manuela Pérez de Vekios"			""	""	""
"Parque Doctor Antonio Rico"	"Parc Doctor Antonio Rico"			""	""	""
"Parque Doctor Esquerdo"	"Parc Doctor Esquerdo"			""	""	""
"Parque Municipal Concepción Vicedo"	"Parc Municipal Concepción Vicedo"			""	""	""
"Parque de las Macetas"	"Parc de las Macetas"			""	""	""
"Parque Presidente Adolfo Suárez"	"Parc Presidente Adolfo Suárez"			""	""	""
"Parque Infantil de Trafico"	"Parc Infantil de Trafico"			""	""	""
"Parque Ingeniero García Antón"	"Parc Ingeniero García Antón"			""	""	""
"Parque Calle Pelayo"	"Parc Calle Pelayo"			""	""	""
"Parque Canino Municipal"	"Parc Canino Municipal"			""	""	""
"Parque Municipal"	"Parc Municipal"			""	""	""
"Parque de José Carreras"	"Parc de José Carreras"			""	""	""
"Parque de Entrepinos"	"Parc de Entrepinos"			""	""	""
"Parque Municipal Ciudad de Elche"	"Parc Municipal Ciudad de Elche"			""	""	""
"Parque Municipal El Canyar de les Portelles"	"Parc Municipal El Canyar de les Portelles"			""	""	""
"parque"	"parque"			""	""	""
"Parque Ansaldo"	"Parc Ansaldo"			""	""	""
"Parque Leonor"	"Parc Leonor"			""	""	""
"Parque Tobago"	"Parc Tobago"			""	""	""
"Parque público"	"Parc público"			""	""	""
"Parque Central Municipal"	"Parc Central Municipal"			""	""	""
"Parque Infantil de Tráfico"	"Parc Infantil de Tráfico"			""	""	""
"Parque Dorado"	"Parc Dorado"			""	""	""
"Parque Paraíso"	"Parc Paraíso"			""	""	""
"Parque Urbano Inundable \"La Marjal\""	"Parc Urbano Inundable \"La Marjal\""			""	""	""
"parque 9 d´octubre"	"parc 9 d´octubre"					
"parque Allende"	"parc Allende"					
"Parque Científico U.M.H. Elche Quorum I.V"	"Parc Científico U.M.H. Elche Quorum I.V"					
"Parque de atraciones de Santa pola"	"Parc de atraciones de Santa pola"					
"Parque Infantil de Tráfico"	"Parc Infantil de Tráfico"					
"Parque de San Jaime"	"Parc de San Jaime"					
"Parque infantil del Polideportivo \"José Vicente Quiles\""	"Parc infantil del Polideportivo \"José Vicente Quiles\""					
"Parque infantil La Pau"	"Parc infantil La Pau"					
"Parque de las palmeras de los niños y niñas de Elche"	"Parc de las palmeras de los niños y niñas de Elche"					
"Parque Comarcal de Bomberos Baix Vinalopó"	"Parc Comarcal de Bomberos Baix Vinalopó"					
"parque de l'Hort del Monjo"	"parc de l'Hort del Monjo"					
"Parque la Aparadora"	"Parc la Aparadora"					
"Parque privado urbanizacón"	"Parc privado urbanizacón"					
"parque Flora"	"parc Flora"					
"Parque de mascotas Altabix"	"Parc de mascotas Altabix"					
"Parque Barco Velero"	"Parc Barco Velero"					
"Parque azul"	"Parc azul"					
"Parque Sorolla"	"Parc Sorolla"					
"Parque María Antón Escolano"	"Parc María Antón Escolano"					
"Parque municipal Sierra de Santa Pola"	"Parc municipal Sierra de Santa Pola"					
"Parque Dama de Elche"	"Parc Dama de Elche"					
"Parque polideportivo"	"Parc polideportivo"					
"Parque Coto Escolar"	"Parc Coto Escolar"	""	""			
"Parque de la M30"	"Parc de la M30"	""	""			
"Parque de los pisos rojos"	"Parc de los pisos rojos"	""	""			
"Parque Municipal Castalla"	"Parc Municipal Castalla"	""	""			
"Parque de Playmobil"	"Parc de Playmobil"	""	""			
"parque de La Glorieta"	"parc de La Glorieta"	""	""			
"Parque Derramador"	"Parc Derramador"	"Parc de los Patos"	"Parque de los Patos"			
"Parque Pocoyó"	"Parc Pocoyó"	""	""			
"Parque Felix"	"Parc Felix"	""	""			
"Parque Dragón"	"Parc Dragón"	""	""			
"Parque canino La dulzura"	"Parc canino La dulzura"	""	""			
"Parque de las bolas"	"Parc de las bolas"	""	""			
"Parque de los abuelos"	"Parc de los abuelos"	""	""			
"Parque tercera edad"	"Parc tercera edad"	""	""			
"Parque de los tubos."	"Parc de los tubos."	""	""			
"Parque de la Vallesa"	"Parc de la Vallesa"					
"Parque infantil de la plaza del Tresmal"	"Parc infantil de la plaza del Tresmal"					
"Parque infantil de la plaza del Palangre"	"Parc infantil de la plaza del Palangre"					
"Parque Villas"	"Parc Villas"					
"Parque L'Enginent"	"Parc L'Enginent"					
"Parque Calalga"	"Parc Calalga"					
"Parque de Plagetes"	"Parc de Plagetes"					
"Parque canino de Benissa"	"Parc canino de Benissa"					
"Parque canino Benissa"	"Parc canino Benissa"					
"Parque Veler"	"Parc Veler"					
"Parque Casiopea"	"Parc Casiopea"					
"Parque Marineta Casiana"	"Parc Marineta Casiana"					
"Parque Oppenheim"	"Parc Oppenheim"					
"Parque Calaga"	"Parc Calaga"					
"Parque Observatorio Recreativo El Pantano"	"Parc Observatorio Recreativo El Pantano"					
"Parque el Gasparot"	"Parc el Gasparot"					
"Parque de las Rosas"	"Parc de las Rosas"					
"Parque Puntes del Moro"	"Parc Puntes del Moro"					
"Parque Lateral Gasparot"	"Parc Lateral Gasparot"					
"Parque La Barbera"	"Parc La Barbera"					
"Parque vertícal"	"Parc vertícal"					
"Parque Botánico"	"Parc Botánico"					
"Parque Los Ribazos"	"Parc Los Ribazos"					
"Parque de los enamorados"	"Parc de los enamorados"					
"Parque Ribetes"	"Parc Ribetes"					
"Parque Villa Romana Barberes"	"Parc Villa Romana Barberes"					
"Parque Marta Baldó"	"Parc Marta Baldó"					
"Parque El oscuro"	"Parc El oscuro"					
"Parque el Torres"	"Parc el Torres"					
"Parque de los Tamarindos"	"Parc de los Tamarindos"					
"Parque Infantil Xaloc"	"Parc Infantil Xaloc"					
"Parque Torresol"	"Parc Torresol"					
"Parque Residencial Loix"	"Parc Residencial Loix"					
"Parque de la ermita de San Isidro"	"Parc de la ermita de San Isidro"					
"Parque de Sant Pere"	"Parc de Sant Pere"					
"Parque infantil Les Rotes"	"Parc infantil Les Rotes"					
"Parque La Carrasca"	"Parc La Carrasca"					
"Parque canino Altea"	"Parc canino Altea"					
"Parque Conservatorio"	"Parc Conservatorio"					
"Parque El Lavadero"	"Parc El Lavadero"					
"Parque CEAM"	"Parc CEAM"					
"Parque Com. Valeciana"	"Parc Com. Valeciana"					
"Parque Com. Valenciana"	"Parc Com. Valenciana"					
"Parque Centro Social"	"Parc Centro Social"					
"Parque Cementeri"	"Parc Cementeri"					
"Parque del cementerio"	"Parc del cementerio"					
"Parque del colegio"	"Parc del colegio"					
"Parque de la Favara"	"Parc de la Favara"					
"Parque de la Capelleta"	"Parc de la Capelleta"					
"Parquecillo"	"Parquecillo"					
"Parque de los Chorros"	"Parc de los Chorros"					
"Parque de Perros"	"Parc de Perros"					
"Parque Noruego"	"Parc Noruego"					
"Parque Guardería municipal"	"Parc Guardería municipal"					
"Parque Municipal de Foietes"	"Parc Municipal de Foietes"					
"Parque de Bomberos El Saler"	"Parc de Bomberos El Saler"					
"Parque de Cabecera"	"Parc de Cabecera"					
"Parque Rojo"	"Parc Rojo"					
"Parque Lluna"	"Parc Lluna"					
"Parque Mar Blava"	"Parc Mar Blava"					
"Parque Lineal"	"Parc Lineal"					
"Parque de la Esperanza"	"Parc de la Esperanza"					
"Parque de Fontanars dels Alforins"	"Parc de Fontanars dels Alforins"					
"Parque de Artillería"	"Parc de Artillería"					
"Parque Central de Bomberos"	"Parc Central de Bomberos"					
"Parque de las ranas"	"Parc de las ranas"					
"Parque de La Estacioneta"	"Parc de La Estacioneta"					
"Parque del Marqués de San Juan"	"Parc del Marqués de San Juan"					
"Parque Escultor García Más"	"Parc Escultor García Más"					
"Parque del Parterre"	"Parc del Parterre"					
"Parque Infantil \"Jardín de Morvedre\""	"Parc Infantil \"Jardín de Morvedre\""					
"Parque de Primado Reig, 12"	"Parc de Primado Reig, 12"					
"Parque Apolonia"	"Parc Apolonia"					
"Parque Ausias"	"Parc Ausias"					
"Parque de la remonta"	"Parc de la remonta"					
"Parque Benicalap"	"Parc Benicalap"					
"Parque de Albacete"	"Parc de Albacete"					
"Parque Eólico Folch II"	"Parc Eólico Folch II"					
"Parque Eólico Plá d'Embalagué"	"Parc Eólico Plá d'Embalagué"					
"Parque Eólico Cabrillas"	"Parc Eólico Cabrillas"					
"Parque Eólico Refoyas"	"Parc Eólico Refoyas"					
"Parque Eólico Muela de Todolella"	"Parc Eólico Muela de Todolella"					
"Parque Eólico Torre Miró II"	"Parc Eólico Torre Miró II"					
"Parque Eólico Torre Miró I"	"Parc Eólico Torre Miró I"					
"parque de la pinada"	"parc de la pinada"					
"Parquesol"	"Parquesol"					
"parque para perros"	"parc para perros"					
"Parque Natural del Turia"	"Parc Natural del Turia"					
"Parque Fluvial del Turia"	"Parc Fluvial del Turia"					
"Parque de Els Colorins"	"Parc de Els Colorins"					
"Parque Rosalia de Castro"	"Parc Rosalia de Castro"					
"parque plaça constitucio"	"parc plaça constitucio"					
"parque del rados"	"parc del rados"					
"parque arrosals"	"parc arrosals"					
"Parque Pizarro"	"Parc Pizarro"					
"Parque 25 de noviembre"	"Parc 25 de noviembre"					
"Parque Avenida"	"Parc Avenida"					
"parque de las pulgas"	"parc de las pulgas"					
"Parque Monte Alegre"	"Parc Monte Alegre"					
"Parque Sur Izquierdo"	"Parc Sur Izquierdo"					
"Parque Sur Derecho"	"Parc Sur Derecho"					
"Parque Rotonda Guillermo Roch"	"Parc Rotonda Guillermo Roch"					
"Parque de Redolins"	"Parc de Redolins"					
"Parque de Chema"	"Parc de Chema"					
"ParqueSol"	"ParqueSol"					
"Parque de la Hermita"	"Parc de la Hermita"					
"Parque Polideportiu"	"Parc Polideportiu"					
"Parque l'Hort de Robertet"	"Parc l'Hort de Robertet"					
"Parque Molí del Bailón"	"Parc Molí del Bailón"					
"Parque de l'Alpelic"	"Parc de l'Alpelic"					
"Parque de San Francisco"	"Parc de San Francisco"					
"Parque Heredia"	"Parc Heredia"					
"Parque Empresarial Turianova"	"Parc Empresarial Turianova"					
"Parque de Bomberos de L'Eliana. Consorcio Provincial de Bomberos de Valencia"	"Parc de Bomberos de L'Eliana. Consorcio Provincial de Bomberos de Valencia"					
"Parque del Cementerio"	"Parc del Cementerio"					
"Parque del Romeral"	"Parc del Romeral"					
"Parque La Gerula Oeste"	"Parc La Gerula Oeste"					
"Parque la Gerula Este"	"Parc la Gerula Este"					
"Parque La Gerula centro"	"Parc La Gerula centro"					
"Parque Goya"	"Parc Goya"					
"Parque Goya Sur"	"Parc Goya Sur"					
"Parque Portón"	"Parc Portón"					
"Parque Rojo Sancarlos"	"Parc Rojo Sancarlos"					
"Parque Sancarlos2"	"Parc Sancarlos2"					
"Parque Sancarlos3"	"Parc Sancarlos3"					
"Parque del Park"	"Parc del Park"					
"Parque del Calvario"	"Parc del Calvario"					
"Parque San Carlos"	"Parc San Carlos"					
"Parque del Xiquet de Betera"	"Parc del Xiquet de Betera"					
"Parque El Romeral"	"Parc El Romeral"					
"Parque Casa Nebot"	"Parc Casa Nebot"					
"Parque Las cuevas"	"Parc Las cuevas"					
"Parque Las cuevas2"	"Parc Las cuevas2"					
"Parque El Cerrao"	"Parc El Cerrao"					
"Parque de Calistenia"	"Parc de Calistenia"					
"Parque de Calco"	"Parc de Calco"					
"Parque de Les Delícies"	"Parc de Les Delícies"					
"Parque de la Pantera Rosa"	"Parc de la Pantera Rosa"					
"Parque de les Moreres"	"Parc de les Moreres"					
"parque d Antella"	"parc d Antella"					
"Parque para mayores"	"Parc para mayores"					
"Parque de la Iglesia"	"Parc de la Iglesia"					
"Parque Pueblo Nuevo"	"Parc Pueblo Nuevo"					
"Parque Glorieta"	"Parc Glorieta"					
"Parque Plaza del 25 Abril"	"Parc Plaza del 25 Abril"					
"Parque del antiguo Mercado"	"Parc del antiguo Mercado"					
"Parque La Milagrosa"	"Parc La Milagrosa"					
"Parque infantil Ramon y Cajal"	"Parc infantil Ramon y Cajal"					
"Parque del Asilo"	"Parc del Asilo"					
"Parque del Mercado"	"Parc del Mercado"					
"Parque infaltil"	"Parc infaltil"					
"Parque El Vidre"	"Parc El Vidre"					
"Parque para perros El Rollet"	"Parc para perros El Rollet"					
"Parque La Marina"	"Parc La Marina"					
"Parque Avenida Europa"	"Parc Avenida Europa"					
"Parque Salvador Castell"	"Parc Salvador Castell"					
"Parque Cabanilles"	"Parc Cabanilles"					
"Parque De La Constitució"	"Parc De La Constitució"					
"Parque Bernat Guinovart"	"Parc Bernat Guinovart"					
"Parque niños"	"Parc niños"					
"Parque del Pla"	"Parc del Pla"					
"Parque del respirall"	"Parc del respirall"					
"Parque Barco Pirata"	"Parc Barco Pirata"					
"Parque de las orcas"	"Parc de las orcas"					
"Parque La mujer Trabajadora"	"Parc La mujer Trabajadora"					
"Parque Félix Rodríguez de la Fuente"	"Parc Félix Rodríguez de la Fuente"					
"Parque Alcalde Salvador Sánchez Arnaldos"	"Parc Alcalde Salvador Sánchez Arnaldos"					
"Parque Pocoyó"	"Parc Pocoyó"					
"parque doctor Pérez López"	"parc doctor Pérez López"					
"parque de la Noria"	"parc de la Noria"					
"Parque El Salitre"	"Parc El Salitre"					
"Parque de la Guardia Civil"	"Parc de la Guardia Civil"					
"Parque del Ravalet"	"Parc del Ravalet"					
"Parque del Casino de Monóvar"	"Parc del Casino de Monóvar"					
"Parque de la Telefonica"	"Parc de la Telefonica"					
"Parque/Plaza del Cristo"	"Parque/Plaza del Cristo"					
"Parque de Santa Bárbara"	"Parc de Santa Bárbara"					
"Parque del Oeste"	"Parc del Oeste"					
"Parque de las Especias"	"Parc de las Especias"					
"parque de la Unión Musical La Artística"	"parc de la Unión Musical La Artística"					
"Parque de las Horcas"	"Parc de las Horcas"					
"parque de la Piedra"	"parc de la Piedra"					
"Parque del Donante de Sangre"	"Parc del Donante de Sangre"					
"Parque de Pablo Iglesias"	"Parc de Pablo Iglesias"					
"parque Unicef"	"parc Unicef"					
"parque Félix Rodríguez de la Fuente"	"parc Félix Rodríguez de la Fuente"					
"parque de Sanchís Guarner"	"parc de Sanchís Guarner"					
"Parque de Tremecén (o de Solo Pizza)"	"Parc de Tremecén (o de Solo Pizza)"					
"Parque pequeño"	"Parc pequeño"					
"Parque Salvador Sánchez Arnaldos"	"Parc Salvador Sánchez Arnaldos"					
"Parque de Pocoyó"	"Parc de Pocoyó"					
"Parque de Carmencita"	"Parc de Carmencita"					
"Parque de la República"	"Parc de la República"					
"Parque del 3x3"	"Parc del 3x3"					
"Parque Primero de Mayo"	"Parc Primero de Mayo"					
"Parque de la Uva"	"Parc de la Uva"					
"Parque de la Garrova"	"Parc de la Garrova"					
"Parque de La Jaula 1"	"Parc de La Jaula 1"					
"Parque de La Jaula 2"	"Parc de La Jaula 2"					
"Parque Fiscal Soledad Cazorla Prieto"	"Parc Fiscal Soledad Cazorla Prieto"					
"Parque Comercial Ledua Park"	"Parc Comercial Ledua Park"					
"Parque La Alameda"	"Parc La Alameda"					
"Parque del L´Almagés"	"Parc del L´Almagés"					
"Parque La Retjola"	"Parc La Retjola"					
"Parque El Jardinet"	"Parc El Jardinet"					
"Parque de les Coves Rojes"	"Parc de les Coves Rojes"					
"Parque del Arrabal"	"Parc del Arrabal"					
"Parque de la Estación"	"Parc de la Estación"					
"Parque de Mayores"	"Parc de Mayores"					
"Parque Canino Les Nyores"	"Parc Canino Les Nyores"					
