"name"	"name:ca"	"alt_name:ca"	"alt_name"	"translations"	"ca.wikipedia_page"	"wikidata_id"
"Plaza Bowl"	"Plaça Bowl"					
"Plaza del cura"	"Plaça del cura"	""	""			""
"Plaza de la Iglesia"	"Plaça de la Iglesia"	""	""			""
"Plaza de Toros"	"Plaça de Toros"	""	""			""
"Plaza de España"	"Plaça de España"	"Plaça de la Iglesia"	"Plaza de la Iglesia"			""
"Plaza de España"	"Plaça de España"	""	""			""
"Plaza de la Iglesia"	"Plaça de la Iglesia"	"Plaça Mayor"	"Plaza Mayor"			""
"Plaza de la Constitución"	"Plaça de la Constitución"	"Plaça de la Constitució"	"Plaça de la Constitució"			""
"Plaza de la urbanización Maestrazgo"	"Plaça de la urbanización Maestrazgo"	""	""			""
"Plaza Espana"	"Plaça Espana"	""	""			""
"Plaza Iglesia"	"Plaça Iglesia"	""	""			""
"Plaza Comunidad General de Aragon"	"Plaça Comunidad General de Aragon"	""	""			""
"Plaza Mayor"	"Plaça Mayor"	""	""			""
"Plaza Nueva"	"Plaça Nueva"	""	""			""
"Plaza del Pilar"	"Plaça del Pilar"	""	""			""
"Plaza de la estación"	"Plaça de la estación"	""	""			""
"Plaza De Las Flores"	"Plaça De Las Flores"	""	""			""
"Plaza del pozo"	"Plaça del pozo"	""	""			""
"Plaza Diputación"	"Plaça Diputación"	""	""			""
"Plaza Foz"	"Plaça Foz"	""	""			""
"Plaza Fuente La Villa"	"Plaça Fuente La Villa"	""	""			""
"Plaza de Santiago Vid"	"Plaça de Santiago Vid"	""	""			""
"Plaza San Miguel"	"Plaça San Miguel"	""	""			""
"Plaza de Toros de Valderrobres"	"Plaça de Toros de Valderrobres"	""	""			"Q101996682"
"Plaza Escuelas Pías"	"Plaça Escuelas Pías"					
"Plaza Mayor"	"Plaça Mayor"					
"Plaza de la Iglesia"	"Plaça de la Iglesia"					
"Plaza Palau Quer"	"Plaça Palau Quer"					
"Plaza Carbasilla"	"Plaça Carbasilla"					
"Plaza Coscoll"	"Plaça Coscoll"					
"Plaza La Iglesia"	"Plaça La Iglesia"					
"Plaza del Portal"	"Plaça del Portal"					
"Plaza del Hospital"	"Plaça del Hospital"					
"Plaza del Arquitecto Pons Sorolla"	"Plaça del Arquitecto Pons Sorolla"					
"plaza de la inmaculada"	"plaça de la inmaculada"					
"Plaza de España"	"Plaça de España"					
"Plaza San Blas"	"Plaça San Blas"					
"Plaza Ramón Y Cajal"	"Plaça Ramón Y Cajal"					
"plaza de los gatos"	"plaça de los gatos"					
"Plaza San Salvador"	"Plaça San Salvador"	""	""			
"Plaza del Ayuntamiento"	"Plaça del Ayuntamiento"	""	""			
"Plaza de la Iglesia"	"Plaça de la Iglesia"	""	""			
"Plaza Tarascon"	"Plaça Tarascon"	""	""			
"Plaza Aragón"	"Plaça Aragón"	""	""			
"Plaza Tarascón"	"Plaça Tarascón"	""	""			
"Plaza Riberola"	"Plaça Riberola"	""	""			
"Plaza Santa Ana"	"Plaça Santa Ana"	""	""			
"Plaza de Valencia"	"Plaça de Valencia"	""	""			
"Plaza de San Salvador"	"Plaça de San Salvador"	""	""			
"Plaza Atarazanas"	"Plaça Atarazanas"	""	""			
"Plaza del Carmen"	"Plaça del Carmen"	""	""			
"Plaza Las Cruces"	"Plaça Las Cruces"	""	""			
"Plaza de España"	"Plaça de España"	""	""			
"Plaza Hort del Hospital"	"Plaça Hort del Hospital"	""	""			
"Plaza del Pilar"	"Plaça del Pilar"	""	""			
"Plaza San Pedro"	"Plaça San Pedro"	""	""			
"Plaza San Roque"	"Plaça San Roque"	""	""			
"Plaza de Severo Ochoa"	"Plaça de Severo Ochoa"	""	""			
"Plaza de Juan XXIII"	"Plaça de Juan XXIII"	"Plaça del Carbó"	"Plaza del Carbón"			
"Plaza San Lorenzo"	"Plaça San Lorenzo"	""	""			
"Plaza del Rosario"	"Plaça del Rosario"					
"Plaza Depósito"	"Plaça Depósito"					
"Plaza España"	"Plaça España"					
"Plaza de los Llanos"	"Plaça de los Llanos"					
"Plaza"	"Plaza"					
"Plaza del Pilar"	"Plaça del Pilar"					
"Plaza del Ayuntamiento"	"Plaça del Ayuntamiento"					
"Plaza de Toros"	"Plaça de Toros"					
"Plaza de los Mártires"	"Plaça de los Mártires"					
"Plaza de los Fueros de Aragón"	"Plaça de los Fueros de Aragón"					
"Plaza del Sot"	"Plaça del Sot"					
"Plaza de la Muela"	"Plaça de la Muela"					
"Plaza de Santa Lucía"	"Plaça de Santa Lucía"					
"Plaza de San Bartolomé"	"Plaça de San Bartolomé"					
"Plaza de San Juan"	"Plaça de San Juan"					
"Plaza de Toros Son Puigdorfila Nou"	"Plaça de Toros Son Puigdorfila Nou"					
"Plaza can Baró"	"Plaça can Baró"					
"Plaza Marques de la Senia"	"Plaça Marques de la Senia"					
"Plaza de Es Baluard"	"Plaça de Es Baluard"					
"Plaza Cementerio"	"Plaça Cementerio"					
"Plaza El Remei"	"Plaça El Remei"					
"Plaza UIB"	"Plaça UIB"					
"plaza de armas"	"plaça de armas"					
"Plaza Industria"	"Plaça Industria"					
"plaza monument a Costa i Llobera"	"plaça monument a Costa i Llobera"					
"Plaza Uno"	"Plaça Uno"					
"Plaza Pedro Ozoup"	"Plaça Pedro Ozoup"					
"Plaza Heriberto Becker"	"Plaça Heriberto Becker"					
"Plaza Santa Ponsa"	"Plaça Santa Ponsa"					
"Plazamar"	"Plazamar"					
"Plaza Bendinat"	"Plaça Bendinat"					
"Plaza de l'Ajuntament"	"Plaça de l'Ajuntament"					
"Plaza del parque"	"Plaça del parque"					
"Plaza d'Isidor Macabich"	"Plaça d'Isidor Macabich"					
"Plaza Mar de Menorca"	"Plaça Mar de Menorca"					
"Plaza del hotel"	"Plaça del hotel"					
"Plaza Paseo Marítimo"	"Plaça Paseo Marítimo"					
"Plaza Inn"	"Plaça Inn"					
"Plaza Francolí"	"Plaça Francolí"					
"Plaza del Mediterrani"	"Plaça del Mediterrani"					
"Plaza verde de Can Periquet"	"Plaça verde de Can Periquet"					
"Plaza Baix Vilar"	"Plaça Baix Vilar"					
"Plazas"	"Plazas"					
"plaza"	"plaza"					
"Plaza i Jardín italiano"	"Plaça i Jardín italiano"					
"Plaza de la Fuente del León"	"Plaça de la Fuente del León"					
"Plaza Verde"	"Plaça Verde"					
"Plaza Verde del Carmè"	"Plaça Verde del Carmè"					
"Plaza Rovellat"	"Plaça Rovellat"					
"Plaza Joan Corrales"	"Plaça Joan Corrales"					
"Plaza de la Rambla"	"Plaça de la Rambla"					
"Plaza del Taxi"	"Plaça del Taxi"					
"Plaza Blas Infante"	"Plaça Blas Infante"					
"Plaza Europa"	"Plaça Europa"					
"Plaza de la Salud"	"Plaça de la Salud"					
"plaza la Illa"	"plaça la Illa"					
"Plaza de los Lapices"	"Plaça de los Lapices"					
"Plaza Bernat Torroja"	"Plaça Bernat Torroja"					
"Plaza Molí de Custodio"	"Plaça Molí de Custodio"					
"Plaza Convento"	"Plaça Convento"					
"Plaza Pintor Cristóbal Bou"	"Plaça Pintor Cristóbal Bou"					
"Plaza San Roque"	"Plaça San Roque"					
"Plaza del Almudín"	"Plaça del Almudín"					
"Plaza de Sant Joan de Casaller"	"Plaça de Sant Joan de Casaller"					
"Plaza de San Antonio"	"Plaça de San Antonio"					
"Plaza Venerable"	"Plaça Venerable"					
"Plaza América"	"Plaça América"					
"Plaza del ayuntamiento"	"Plaça del ayuntamiento"					
"Plaza de Mosén Baltasar"	"Plaça de Mosén Baltasar"					
"Plaza de Canalejas"	"Plaça de Canalejas"					
"Plaza Iglesia"	"Plaça Iglesia"					
"Plaza del Doctor Joaquín Ballester"	"Plaça del Doctor Joaquín Ballester"					
"Plaza de Don Blasco"	"Plaça de Don Blasco"					
"Plaza de Joaquín Ballester"	"Plaça de Joaquín Ballester"					
"Plaza del Viento"	"Plaça del Viento"					
"Plaza de la Constitución"	"Plaça de la Constitución"					
"Plaza de Tanduay"	"Plaça de Tanduay"					
"Plaza Santa María"	"Plaça Santa María"					
"Plaza Estación"	"Plaça Estación"					
"Plaza Ricardo Cardona"	"Plaça Ricardo Cardona"					
"Plaza San Ramón"	"Plaça San Ramón"					
"Plaza Justo Zaragoza"	"Plaça Justo Zaragoza"					
"Plaza Armas"	"Plaça Armas"					
"Plaza de las Fabricas"	"Plaça de las Fabricas"					
"Plaza del Maestrazgo"	"Plaça del Maestrazgo"					
"Plaza de la Paz"	"Plaça de la Paz"					
"Plaza Ramón y Cajal"	"Plaça Ramón y Cajal"					
"Plaza Arrabal"	"Plaça Arrabal"					
"Plaza Constitución"	"Plaça Constitución"					
"Plaza Horno Viejo"	"Plaça Horno Viejo"					
"Plaza Hornoviejo"	"Plaça Hornoviejo"					
"Plaza Blasco Ibañez"	"Plaça Blasco Ibañez"					
"Plaza del Primero de Mayo"	"Plaça del Primero de Mayo"					
"Plaza Tetuán"	"Plaça Tetuán"	""	""			
"Plaza de la Independencia"	"Plaça de la Independencia"	""	""			
"Plaza Borrull"	"Plaça Borrull"	""	""			
"Plaza de las Aulas"	"Plaça de las Aulas"	""	""			
"Plaza Clavé"	"Plaça Clavé"	""	""			
"Plaza Santa Teresa"	"Plaça Santa Teresa"	""	""			
"Plaza Mayor"	"Plaça Mayor"	""	""			
"Plaza Rey Don Jaime"	"Plaça Rey Don Jaime"	""	""			
"Plaza San Martín"	"Plaça San Martín"	""	""			
"Plaza de Todos los Santos"	"Plaça de Todos los Santos"	""	""			
"Plaza Artista Ripollés"	"Plaça Artista Ripollés"	""	""			
"Plaza Urbán"	"Plaça Urbán"	""	""			
"Plaza de la Bonaigua"	"Plaça de la Bonaigua"	""	""			
"Plaza Mar de Barents"	"Plaça Mar de Barents"	""	""			
"Plaza de Elche"	"Plaça de Elche"	""	""			
"Plaza Viena"	"Plaça Viena"	""	""			
"Plaza Víctor Falomir"	"Plaça Víctor Falomir"	""	""			
"Plaza de las Lagunas de Ruidera"	"Plaça de las Lagunas de Ruidera"	""	""			
"Plaza de La Concordia"	"Plaça de La Concordia"	""	""			
"Plaza Jaime Ribes"	"Plaça Jaime Ribes"	""	""			
"Plaza de las comunicaciones"	"Plaça de las comunicaciones"	""	""			
"Plaza Antigua Fábrica Fernando Diago"	"Plaça Antigua Fábrica Fernando Diago"	""	""			
"Plaza Maset Blau"	"Plaça Maset Blau"	""	""			
"Plaza del Esperanto"	"Plaça del Esperanto"	""	""			
"Plaza Río Albentosa"	"Plaça Río Albentosa"	""	""			
"Plaza Monte de Piedad"	"Plaça Monte de Piedad"	""	""			
"Plaza Libertad"	"Plaça Libertad"	""	""			
"Plaza Sierra Esparraguera"	"Plaça Sierra Esparraguera"	""	""			
"Plaza Río Terde"	"Plaça Río Terde"	""	""			
"Plaza Albentosa"	"Plaça Albentosa"	""	""			
"Plaza Botánico Calduch"	"Plaça Botánico Calduch"	""	""			
"Plaza Doctor Marañón"	"Plaça Doctor Marañón"	""	""			
"Plaza de la Olivera"	"Plaça de la Olivera"	""	""			
"Plaza de l'Espigol"	"Plaça de l'Espigol"	""	""			
"Plaza Mallorca"	"Plaça Mallorca"	""	""			
"Plaza Escuelas Pías"	"Plaça Escuelas Pías"	""	""			
"Plaza del Cronista Muntaner"	"Plaça del Cronista Muntaner"	""	""			
"Plaza del Maestrazgo"	"Plaça del Maestrazgo"	""	""			
"Plaza Ronda Magdalena"	"Plaça Ronda Magdalena"	""	""			
"Plaza Donoso Cortés"	"Plaça Donoso Cortés"	""	""			
"Plaza de Tetuán"	"Plaça de Tetuán"	""	""			
"Plaza Hernán Cortés"	"Plaça Hernán Cortés"	""	""			
"Plaza Na Violant"	"Plaça Na Violant"	""	""			
"Plaza Escultor Adsuara"	"Plaça Escultor Adsuara"	""	""			
"Plaza Miguel Bellido"	"Plaça Miguel Bellido"	""	""			
"Plaza de Bucarest"	"Plaça de Bucarest"	""	""			
"Plaza del Doctor Sánchez Gozalbo"	"Plaça del Doctor Sánchez Gozalbo"	""	""			
"Plaza Juan XXIII"	"Plaça Juan XXIII"	""	""			
"Plaza Illes Columbretes"	"Plaça Illes Columbretes"	""	""			
"Plaza Isabel la Católica"	"Plaça Isabel la Católica"	"Plaça de l'Ereta"	"Plaça de l'Ereta"			
"Plaza del Dolçainer de Tales"	"Plaça del Dolçainer de Tales"	""	""			
"Plaza María Agustina"	"Plaça María Agustina"	""	""			
"Plaza Vicent Andrés Estellés"	"Plaça Vicent Andrés Estellés"	""	""			
"Plaza Herrero Tejedor"	"Plaça Herrero Tejedor"	""	""			
"Plaza Mariana Pineda"	"Plaça Mariana Pineda"	""	""			
"Plaza Cayo Gironés Álvarez"	"Plaça Cayo Gironés Álvarez"	""	""			
"Plaza de la Gaiata"	"Plaça de la Gaiata"	""	""			
"Plaza Teodoro Izquierdo"	"Plaça Teodoro Izquierdo"	""	""			
"Plaza La Font"	"Plaça La Font"	""	""			
"Plaza de la Verbena"	"Plaça de la Verbena"	""	""			
"Plaza Ventorrillo"	"Plaça Ventorrillo"	""	""			
"Plaza de la Tanca"	"Plaça de la Tanca"	""	""			
"Plaza Raval"	"Plaça Raval"	""	""			
"Plaza de la Placita"	"Plaça de la Placita"	""	""			
"Plaza Abadia"	"Plaça Abadia"	""	""			
"Plaza Zacarías Martín"	"Plaça Zacarías Martín"	""	""			
"Plaza Miquel Peris i Segarra"	"Plaça Miquel Peris i Segarra"	""	""			
"Plaza Peixatera"	"Plaça Peixatera"	""	""			
"Plaza del Mar"	"Plaça del Mar"	""	""			
"Plaza Virgen del Carmen"	"Plaça Virgen del Carmen"	""	""			
"Plaza París"	"Plaça París"	""	""			
"Plaza de la Constitución"	"Plaça de la Constitución"	""	""			
"Plaza Ancla"	"Plaça Ancla"	""	""			
"Plaza de toros"	"Plaça de toros"	""	""			
"Plaza de la Estación"	"Plaça de la Estación"	""	""			
"Plaza Príncipe de Asturias"	"Plaça Príncipe de Asturias"	""	""			
"Plaza Principe de Asturias"	"Plaça Principe de Asturias"	""	""			
"Plaza de Ramón y Cajal"	"Plaça de Ramón y Cajal"	""	""			
"Plaza de San Bartolomé"	"Plaça de San Bartolomé"	""	""			
"Plaza de la Ermita"	"Plaça de la Ermita"	""	""			
"Plaza del Mercado"	"Plaça del Mercado"	""	""			
"Plaza Tres Culturas"	"Plaça Tres Culturas"					
"Plaza María Cases"	"Plaça María Cases"					
"Plaza de Silvestre Segarra"	"Plaça de Silvestre Segarra"					
"Plaza Silvestre Segarra"	"Plaça Silvestre Segarra"					
"Plaza Abadía"	"Plaça Abadía"					
"Plaza del Santo Ángel"	"Plaça del Santo Ángel"					
"Plaza de Oriente"	"Plaça de Oriente"					
"Plaza de Santiago Obón"	"Plaça de Santiago Obón"					
"Plaza de Mosén Recaredo Centelles"	"Plaça de Mosén Recaredo Centelles"					
"Plaza de San José"	"Plaça de San José"					
"Plaza Duques de Segorbe"	"Plaça Duques de Segorbe"					
"Plaza del Molino"	"Plaça del Molino"					
"Plaza Nuestra Señora de la Asunción"	"Plaça Nuestra Señora de la Asunción"					
"Plaza Espardenyers"	"Plaça Espardenyers"					
"Plaza de Isaac Peral"	"Plaça de Isaac Peral"					
"Plaza del Mercado"	"Plaça del Mercado"					
"Plaza Villamargo"	"Plaça Villamargo"					
"Plaza Buenavista"	"Plaça Buenavista"					
"Plaza de Ismael Llopis"	"Plaça de Ismael Llopis"					
"Plaza la Paz"	"Plaça la Paz"					
"Plaza del Centro"	"Plaça del Centro"					
"Plaza del Circo"	"Plaça del Circo"					
"Plaza Parque 9 de octubre"	"Plaça Parque 9 de octubre"					
"Plaza Asunción"	"Plaça Asunción"					
"Plaza Villavieja"	"Plaça Villavieja"					
"Plaza de San Vicente"	"Plaça de San Vicente"					
"Plaza de San Roque"	"Plaça de San Roque"					
"Plaza del Castillo"	"Plaça del Castillo"					
"Plaza Juan Sebastian Elcano"	"Plaça Juan Sebastian Elcano"					
"Plaza Playa Sapu"	"Plaça Playa Sapu"					
"Plaza del Santísimo Cristo de la Junquera"	"Plaça del Santísimo Cristo de la Junquera"					
"Plaza de Villavieja"	"Plaça de Villavieja"					
"Plaza de la Comunidad Valenciana"	"Plaça de la Comunidad Valenciana"					
"Plaza del Jardín"	"Plaça del Jardín"					
"Plaza de Alfonso XIII"	"Plaça de Alfonso XIII"					
"Plaza Columbretes"	"Plaça Columbretes"					
"Plaza de Juan Pablo II"	"Plaça de Juan Pablo II"					
"Plaza El Pla"	"Plaça El Pla"					
"Plaza del Pintor Sorolla"	"Plaça del Pintor Sorolla"					
"Plaza de Ruiz Picasso"	"Plaça de Ruiz Picasso"					
"Plaza Juan XXIII"	"Plaça Juan XXIII"					
"Plaza de La Ermita"	"Plaça de La Ermita"					
"Plaza de Nuestra Señora de Lourdes"	"Plaça de Nuestra Señora de Lourdes"					
"Plaza Puerta del Sol"	"Plaça Puerta del Sol"					
"Plaza Fray Asensi Nebot"	"Plaça Fray Asensi Nebot"					
"Plaza de José Sorribes Fuster"	"Plaça de José Sorribes Fuster"					
"Plaza Nueva"	"Plaça Nueva"					
"Plaza de las Eras"	"Plaça de las Eras"					
"Plaza del Cantón"	"Plaça del Cantón"					
"Plaza de San Miguel"	"Plaça de San Miguel"					
"Plaza San Miguel"	"Plaça San Miguel"					
"Plaza Fuente Planillo"	"Plaça Fuente Planillo"					
"Plaza del Pardinal"	"Plaça del Pardinal"					
"Plaza de Santa Ana"	"Plaça de Santa Ana"					
"Plaza de la Virgen del Carmen"	"Plaça de la Virgen del Carmen"					
"Plaza MIiralpeix"	"Plaça MIiralpeix"					
"Plaza de Montí"	"Plaça de Montí"					
"Plaza Madrid"	"Plaça Madrid"					
"Plaza l'Almudi"	"Plaça l'Almudi"					
"Plaza el Pla"	"Plaça el Pla"					
"Plaza de la Música"	"Plaça de la Música"					
"Plaza Rey Don Jaime"	"Plaça Rey Don Jaime"					
"Plaza Zayyan"	"Plaça Zayyan"					
"Plaza Raval de Sant Josep"	"Plaça Raval de Sant Josep"					
"Plaza de Sancho"	"Plaça de Sancho"					
"Plaza Raval San José"	"Plaça Raval San José"					
"Plaza Sinagoga"	"Plaça Sinagoga"					
"Plaza de la Morera"	"Plaça de la Morera"					
"Plaza de las Tres Culturas"	"Plaça de las Tres Culturas"					
"Plaza Antonio Machado"	"Plaça Antonio Machado"					
"Plaza Pablo Iglesias"	"Plaça Pablo Iglesias"					
"Plaza Miguel Hernández"	"Plaça Miguel Hernández"					
"Plaza Santo Domingo"	"Plaça Santo Domingo"					
"Plaza San Cristóbal"	"Plaça San Cristóbal"					
"Plaza Siglo XXI"	"Plaça Siglo XXI"					
"Plaza NUEVA"	"Plaça NUEVA"					
"Plaza Manuel Escobedo"	"Plaça Manuel Escobedo"					
"Plaza Bayarri"	"Plaça Bayarri"					
"Plaza Alguer"	"Plaça Alguer"					
"Plaza del Labrador"	"Plaça del Labrador"					
"Plaza de la Libertad"	"Plaça de la Libertad"					
"Plaza de los Pescadores"	"Plaça de los Pescadores"					
"Plaza del Castell"	"Plaça del Castell"					
"Plaza Francisco Gil"	"Plaça Francisco Gil"					
"Plaza de la Gran Valencia"	"Plaça de la Gran Valencia"					
"Plaza de la Trinidad"	"Plaça de la Trinidad"					
"Plaza de Antonio José Cavanilles"	"Plaça de Antonio José Cavanilles"					
"Plaza de Torres Quevedo"	"Plaça de Torres Quevedo"					
"Plaza Vicente Aleixandre"	"Plaça Vicente Aleixandre"					
"Plaza Jacinto Benavente"	"Plaça Jacinto Benavente"					
"Plaza Noguera"	"Plaça Noguera"					
"Plaza José Saramago"	"Plaça José Saramago"					
"Plaza de la Concordia"	"Plaça de la Concordia"					
"Plaza Bernardo Ormaechea"	"Plaça Bernardo Ormaechea"					
"Plaza del Congo"	"Plaça del Congo"					
"Plaza de Cieza"	"Plaça de Cieza"					
"Plaza de los Pueblos"	"Plaça de los Pueblos"					
"Plaza Eduardo Merello Llasera"	"Plaça Eduardo Merello Llasera"					
"Plaza Luis Álvarez"	"Plaça Luis Álvarez"					
"Plaza Manuel Azaña"	"Plaça Manuel Azaña"					
"Plaza del Rius"	"Plaça del Rius"					
"Plaza San José"	"Plaça San José"					
"Plaza Castello"	"Plaça Castello"					
"Plaza Onze de Març"	"Plaça Onze de Març"					
"Plaza Espigol"	"Plaça Espigol"					
"Plaza La Victoria"	"Plaça La Victoria"					
"Plaza Angel Perales"	"Plaça Angel Perales"					
"Plaza Narciso Yepes"	"Plaça Narciso Yepes"					
"Plaza Ermita"	"Plaça Ermita"					
"Plaza Ermita de Campolivar"	"Plaça Ermita de Campolivar"					
"Plaza de Casa de Cultura"	"Plaça de Casa de Cultura"					
"Plaza Pou de San Vicent"	"Plaça Pou de San Vicent"					
"Plaza de la Cruz"	"Plaça de la Cruz"					
"Plaza de los Pioneros"	"Plaça de los Pioneros"					
"Plaza San Juan de la Ribera"	"Plaça San Juan de la Ribera"					
"Plaza Pío XII"	"Plaça Pío XII"					
"Plaza España / Barranquet"	"Plaça España / Barranquet"					
"Plaza Valldecabres"	"Plaça Valldecabres"					
"Plaza de la Victoria"	"Plaça de la Victoria"					
"Plaza de Rafael Atard"	"Plaça de Rafael Atard"					
"Plaza Dos de Mayo"	"Plaça Dos de Mayo"					
"Plaza Vicente Barberá Armelles"	"Plaça Vicente Barberá Armelles"					
"Plaza de la Flor"	"Plaça de la Flor"					
"Plaza Corazón de Jesús"	"Plaça Corazón de Jesús"					
"Plaza Virgen de los Desamparados"	"Plaça Virgen de los Desamparados"					
"Plaza Miramar"	"Plaça Miramar"					
"Plaza el Barranquet"	"Plaça el Barranquet"					
"Plaza de los Derechos Humanos"	"Plaça de los Derechos Humanos"					
"Plaza de Elche"	"Plaça de Elche"					
"Plaza Gerardo Salvador"	"Plaça Gerardo Salvador"					
"Plaza Soliera"	"Plaça Soliera"	""	""			
"Plaza Xúquer"	"Plaça Xúquer"	""	""			
"Plaza Señera"	"Plaça Señera"	""	""			
"Plaza Font del Barco"	"Plaça Font del Barco"	""	""			
"Plaza Juan Mari Ricart"	"Plaça Juan Mari Ricart"	""	""			
"Plaza El Jardin"	"Plaça El Jardin"	"Plaça El Jardi"	"Plaça El Jardi"			
"Plaza Esglesia"	"Plaça Esglesia"	"Plaça Iglesia"	"Plaza Iglesia"			
"Plaza de los Caidos"	"Plaça de los Caidos"	""	""			
"Plaza de los Caídos"	"Plaça de los Caídos"	""	""			
"Plaza Consolat del Mar"	"Plaça Consolat del Mar"	""	""			
"Plaza Alquería de la Culla"	"Plaça Alquería de la Culla"	""	""			
"Plaza Maestro Rodrigo"	"Plaça Maestro Rodrigo"	""	""			
"Plaza de Cervantes"	"Plaça de Cervantes"	""	""			
"Plaza de la Casota"	"Plaça de la Casota"	""	""			
"Plaza del 3 de Abril"	"Plaça del 3 de Abril"	""	""			
"plaza vieja nota musical"	"plaça vieja nota musical"	""	""			
"Plaza de Lepanto"	"Plaça de Lepanto"	""	""			
"Plaza Caja de Ahorros"	"Plaça Caja de Ahorros"	""	""			
"Plaza Poeta Miguel Hernández"	"Plaça Poeta Miguel Hernández"	""	""			
"Plaza Cardenal Benlloch"	"Plaça Cardenal Benlloch"	""	""			
"Plaza de Italia"	"Plaça de Italia"	""	""			
"Plaza Vicente Blanch"	"Plaça Vicente Blanch"	""	""			
"Plaza Jaume I, el Conqueridor"	"Plaça Jaume I, el Conqueridor"	""	""			
"Plaza Santa Barbara"	"Plaça Santa Barbara"					
"Plaza de la Xirrina"	"Plaça de la Xirrina"					
"Plaza Ramón Martí"	"Plaça Ramón Martí"					
"Plaza Poeta Miguel Hernández"	"Plaça Poeta Miguel Hernández"					
"Plaza Doctor José Moya"	"Plaça Doctor José Moya"					
"Plaza Sant Jaume"	"Plaça Sant Jaume"					
"Plaza Sant Jaune"	"Plaça Sant Jaune"					
"Plaza delEspañoleto"	"Plaça delEspañoleto"					
"Plaza l'Esglesia"	"Plaça l'Esglesia"					
"Plaza de la nativitat"	"Plaça de la nativitat"					
"Plaza Sant Jordi o de la Galera"	"Plaça Sant Jordi o de la Galera"					
"Plaza Trinitat"	"Plaça Trinitat"					
"Plaza de Santa Tecla"	"Plaça de Santa Tecla"					
"Plaza Trinquet"	"Plaça Trinquet"					
"Plaza de Sant Pere"	"Plaça de Sant Pere"					
"Plaza Font dels 25 Dolls"	"Plaça Font dels 25 Dolls"					
"Plaza Beato Berardo"	"Plaça Beato Berardo"					
"Plaza de la Constitucion"	"Plaça de la Constitucion"					
"Plaza Enric Valer"	"Plaça Enric Valer"					
"Plaza Inglesia"	"Plaça Inglesia"					
"Plaza del Mercat"	"Plaça del Mercat"					
"plaza Mayor"	"plaça Mayor"					
"Plaza San Antonio"	"Plaça San Antonio"					
"Plaza Nou d'Octubre"	"Plaça Nou d'Octubre"					
"Plaza Andres Piles"	"Plaça Andres Piles"					
"Plaza de Enric Valor"	"Plaça de Enric Valor"					
"Plaza de toros"	"Plaça de toros"					
"Plaza Dr. Gómez Ferrer"	"Plaça Dr. Gómez Ferrer"					
"Plaza Monrubio"	"Plaça Monrubio"	""	""			
"Plaza Masiana"	"Plaça Masiana"	""	""			
"Plaza General Ripoll"	"Plaça General Ripoll"	""	""			
"Plaza de la Safor"	"Plaça de la Safor"	""	""			
"Plaza Constitución"	"Plaça Constitución"	""	""			
"Plaza  Constitución"	"Plaça  Constitución"	""	""			
"Plaza dels Tarongers"	"Plaça dels Tarongers"	""	""			
"Plaza Nou d'Octobre"	"Plaça Nou d'Octobre"	""	""			
"Plaza Rosa dels Vents"	"Plaça Rosa dels Vents"	""	""			
"Plaza del Pais"	"Plaça del Pais"	""	""			
"Plaza de Aiuntament"	"Plaça de Aiuntament"	""	""			
"Plaza Eglesia"	"Plaça Eglesia"	""	""			
"Plaza Sant Vicent"	"Plaça Sant Vicent"	""	""			
"Plaza Don Francisco Carroz"	"Plaça Don Francisco Carroz"	""	""			
"Plaza Sant Antoni"	"Plaça Sant Antoni"	""	""			
"Plaza Hort"	"Plaça Hort"	""	""			
"Plaza Beato Carmela"	"Plaça Beato Carmela"	""	""			
"Plaza Olivera"	"Plaça Olivera"	""	""			
"Plaza Benipeixcar"	"Plaça Benipeixcar"	""	""			
"Plaza Doctor Ferran"	"Plaça Doctor Ferran"	""	""			
"Plaza de las chocolateras"	"Plaça de las chocolateras"	""	""			
"Plaza del Moli"	"Plaça del Moli"	""	""			
"Plaza Tirant Lo Blanc"	"Plaça Tirant Lo Blanc"	""	""			
"Plaza Major"	"Plaça Major"	""	""			
"Plaza Pare Pons"	"Plaça Pare Pons"	""	""			
"Plaza de Ganguis"	"Plaça de Ganguis"	""	""			
"Plaza de la Costera"	"Plaça de la Costera"	""	""			
"Plaza Joan Fuster"	"Plaça Joan Fuster"	"Avenida Blasco Ibáñez"	"Avenida Blasco Ibáñez"			
"Plaza Colón"	"Plaça Colón"	""	""			
"Plaza Sant Josep"	"Plaça Sant Josep"	""	""			
"Plaza Nou d'Octubre"	"Plaça Nou d'Octubre"	""	""			
"Plaza de la Cisterna"	"Plaça de la Cisterna"	""	""			
"Plaza Generalitat"	"Plaça Generalitat"	""	""			
"Plaza Consell"	"Plaça Consell"	""	""			
"Plaza Carmesina"	"Plaça Carmesina"	""	""			
"Plaza els Furs"	"Plaça els Furs"					
"Plaza Joan de Joanes"	"Plaça Joan de Joanes"					
"Plaza del Ajuntament"	"Plaça del Ajuntament"					
"Plaza Olmets"	"Plaça Olmets"					
"Plaza Raco de Capito"	"Plaça Raco de Capito"					
"Plaza San Vincente"	"Plaça San Vincente"					
"Plaza Sant Domingo"	"Plaça Sant Domingo"					
"Plaza Virgen de Loreto"	"Plaça Virgen de Loreto"					
"Plaza de la Roca"	"Plaça de la Roca"					
"Plaza de la Villa"	"Plaça de la Villa"					
"Plaza Horno"	"Plaça Horno"					
"Plaza Major"	"Plaça Major"					
"Plaza Primer de Maig"	"Plaça Primer de Maig"					
"Plaza del Palau"	"Plaça del Palau"					
"Plaza les Eres"	"Plaça les Eres"					
"Plaza Cervantes"	"Plaça Cervantes"					
"Plaza Lluis Vives"	"Plaça Lluis Vives"					
"Plaza de la Luna"	"Plaça de la Luna"	""	""	""	""	""
"Plaza Del Cemeterio, 1"	"Plaça Del Cemeterio, 1"	""	""	""	""	""
"Plaza Fester Paco Botella"	"Plaça Fester Paco Botella"	""	""	""	""	""
"plaza Rodrigo Navarro"	"plaça Rodrigo Navarro"	""	""	""	""	""
"Plaza Juan Pablo II - Médico Luis Rivera"	"Plaça Juan Pablo II - Médico Luis Rivera"	""	""	""	""	""
"Plaza Juan Pablo II, 20"	"Plaça Juan Pablo II, 20"	""	""	""	""	""
"Plaza De Los Luceros, 17"	"Plaça De Los Luceros, 17"	""	""	""	""	""
"Plaza Ruperto Chapí, 3"	"Plaça Ruperto Chapí, 3"	""	""	""	""	""
"Plaza De Los Luceros, 8"	"Plaça De Los Luceros, 8"	""	""	""	""	""
"Plaza De Los Luceros, 2"	"Plaça De Los Luceros, 2"	""	""	""	""	""
"Plaza Canalla"	"Plaça Canalla"	""	""	""	""	""
"Plaza de España, 7 - Pza. de Toros II"	"Plaça de España, 7 - Pza. de Toros II"	""	""	""	""	""
"Plaza De España, 4"	"Plaça De España, 4"	""	""	""	""	""
"Plaza De España, 5"	"Plaça De España, 5"	""	""	""	""	""
"Plaza Puerta del Mar"	"Plaça Puerta del Mar"	""	""	""	""	""
"Plaza Puerta Del Mar"	"Plaça Puerta Del Mar"	""	""	""	""	""
"Plaza 6"	"Plaça 6"	""	""	""	""	""
"Plaza De España, 7 - Pza. De Toros"	"Plaça De España, 7 - Pza. De Toros"	""	""	""	""	""
"Plaza Santa Teresa, 14"	"Plaça Santa Teresa, 14"	""	""	""	""	""
"Plaza Santa Teresa, 5"	"Plaça Santa Teresa, 5"	""	""	""	""	""
"Plaza De España - Panteón de Quijano"	"Plaça De España - Panteón de Quijano"	""	""	""	""	""
"Plaza Doctor Gómez Ulla, 3"	"Plaça Doctor Gómez Ulla, 3"	""	""	""	""	""
"Plaza de América - Pintor Baeza"	"Plaça de América - Pintor Baeza"	""	""	""	""	""
"Plaza America - Jaime Segarra"	"Plaça America - Jaime Segarra"	""	""	""	""	""
"Plaza de Pío XII, 6"	"Plaça de Pío XII, 6"	""	""	""	""	""
"Plaza Estella, 6"	"Plaça Estella, 6"	""	""	""	""	""
"plaza de Europa"	"plaça de Europa"	""	""	""	""	""
"plaza Miguel Hernández"	"plaça Miguel Hernández"	""	""	""	""	""
"Plaza de la Armonia"	"Plaça de la Armonia"	""	""	""	""	""
"plaza de America"	"plaça de America"	""	""	""	""	""
"Plaza del Alcalde Agatángelo Soler, 4"	"Plaça del Alcalde Agatángelo Soler, 4"	""	""	""	""	""
"Plaza Alcalde Agatángelo Soler, 6"	"Plaça Alcalde Agatángelo Soler, 6"	""	""	""	""	""
"Plaza Castalla - Antonio Amorós"	"Plaça Castalla - Antonio Amorós"	""	""	""	""	""
"Plaza San Roque"	"Plaça San Roque"	""	""	""	""	""
"Plaza José Sala"	"Plaça José Sala"	""	"Plaza de los Hierros"	""	""	""
"Plaza de Maisonave"	"Plaça de Maisonave"	""	""	""	""	""
"Plaza Nueva"	"Plaça Nueva"	""	""	""	""	""
"Plaza De La Coruña"	"Plaça De La Coruña"	""	""	""	""	""
"Plaza de la Constitución, 4"	"Plaça de la Constitución, 4"	""	""	""	""	""
"Plaza de Carlos III"	"Plaça de Carlos III"	""	""	""	""	""
"Plaza central"	"Plaça central"	""	""	""	""	""
"Plaza Madreselva"	"Plaça Madreselva"	""	""	""	""	""
"plaza José Antonio Torá"	"plaça José Antonio Torá"	""	""	""	""	""
"plaza de la Luna"	"plaça de la Luna"	""	""	""	""	""
"plaza de San Jaime"	"plaça de San Jaime"	""	""	""	""	""
"plaza Fester Paco Botella"	"plaça Fester Paco Botella"	""	""	""	""	""
"Plaza José Cabo"	"Plaça José Cabo"	""	""	""	""	""
"plaza Enrique López Vidal"	"plaça Enrique López Vidal"	""	""	""	""	""
"plaza de la Fabriqueta"	"plaça de la Fabriqueta"	""	""	""	""	""
"plaza El Refugio"	"plaça El Refugio"	""	""	""	""	""
"Plaza Menéndez Pelayo"	"Plaça Menéndez Pelayo"	""	""	""	""	""
"plaza de Navarro Rodrigo"	"plaça de Navarro Rodrigo"	""	"la Replaceta"	""	""	""
"plaza Florida-Babel"	"plaça Florida-Babel"	""	""	""	""	""
"plaza farmaceútico Luis Gisbert"	"plaça farmaceútico Luis Gisbert"	""	""	""	""	""
"Plaza María Yolanda Escrich Forniés"	"Plaça María Yolanda Escrich Forniés"	"plaça de la Igualtat"	""	""	""	""
"plaza de Canalejas"	"plaça de Canalejas"	""	""	""	""	""
"plaza deportista Manuel Muñoz"	"plaça deportista Manuel Muñoz"	""	""	""	""	""
"Plaza Arquitecto Miguel López"	"Plaça Arquitecto Miguel López"	""	""	""	""	""
"Plaza Arquitecto Miguel López"	"Plaça Arquitecto Miguel López"	""	""	"Plaça Arquitecte Miguel López"	"Plaça Arquitecte Miguel López"	"Q87772947"
"Plaza del Grupo Escolar de Benalúa"	"Plaça del Grupo Escolar de Benalúa"	""	""	""	""	""
"plaza Galicia"	"plaça Galicia"	""	""	""	""	""
"Plaza de Séneca"	"Plaça de Séneca"	""	""	""	""	""
"Plaza Canalejas"	"Plaça Canalejas"	""	""	""	""	""
"plaza de Galicia"	"plaça de Galicia"	""	""	""	""	""
"plaza Magallares"	"plaça Magallares"	""	""	""	""	""
"plaza padre Ángel de Carcagente"	"plaça padre Ángel de Carcagente"	""	""	""	""	""
"plaza papa Juan Pablo II"	"plaça papa Juan Pablo II"	""	""	""	""	""
"plaza de la Viña"	"plaça de la Viña"	""	""	""	""	""
"plaza Florida-Portazgo"	"plaça Florida-Portazgo"	""	""	""	""	""
"Plaza de la Viña"	"Plaça de la Viña"	""	""	""	""	""
"plaza de San Blas"	"plaça de San Blas"	""	""	""	""	""
"Plaza Franklin Albricias Goetz"	"Plaça Franklin Albricias Goetz"	""	""	""	""	""
"plaza biógrafo Manuel Rico"	"plaça biógrafo Manuel Rico"	""	""	""	""	""
"plaza José Rico Pérez"	"plaça José Rico Pérez"	""	""	""	""	""
"plaza del olímpico Juan Escarré"	"plaça del olímpico Juan Escarré"	""	""	""	""	""
"plaza San Agustín"	"plaça San Agustín"	""	""	""	""	""
"plaza del Pintor Lorenzo Aguirre"	"plaça del Pintor Lorenzo Aguirre"	""	""	""	""	""
"plaza del General Mancha"	"plaça del General Mancha"	""	""	""	""	""
"Plaza Nueva"	"Plaça Nueva"	""	"Plaza de los Peces"	"Plaça Nova (Alacant), Plaça Nova"	"Plaça Nova (Alacant)"	"Q11104774"
"plaza Doctor Balmis"	"plaça Doctor Balmis"	""	""	""	""	""
"plaza de la Muntanyeta"	"plaça de la Muntanyeta"	""	""	""	""	""
"Plaza Gabriel Miró"	"Plaça Gabriel Miró"	""	""	""	""	""
"Plaza Puerta de San Francisco"	"Plaça Puerta de San Francisco"	""	""	""	""	""
"plaza padre Fontova"	"plaça padre Fontova"	""	""	""	""	""
"plaza de España"	"plaça de España"	""	""	""	""	""
"plaza de Les Oliveretes"	"plaça de Les Oliveretes"	""	""	""	""	""
"plaza San Antonio"	"plaça San Antonio"	""	""	""	""	""
"plaza Hermanos Pascual"	"plaça Hermanos Pascual"	""	""	""	""	""
"plaza Portal de Elche"	"plaça Portal de Elche"	""	""	""	""	""
"plaza del Carmen"	"plaça del Carmen"	""	""	""	""	""
"Plaza de Quijano"	"Plaça de Quijano"	""	""	""	""	""
"Plaza de Santa María"	"Plaça de Santa María"	""	""	""	""	""
"plaza de la Virgen del Remedio"	"plaça de la Virgen del Remedio"	""	""	""	""	""
"Plaza Paseíto Ramiro"	"Plaça Paseíto Ramiro"	""	""	""	""	""
"Plaza de la Santísima Faz"	"Plaça de la Santísima Faz"	""	""	""	""	""
"Plaza del Abad Penalva"	"Plaça del Abad Penalva"	""	""	""	""	""
"plaza de la Santa Cruz"	"plaça de la Santa Cruz"	""	""	""	""	""
"plaza del Mar"	"plaça del Mar"	""	""	""	""	""
"Plaza Mar 2"	"Plaça Mar 2"	""	""	"Plaza Mar 2"	"Plaza Mar 2"	"Q56596858"
"plaza de la Estrella"	"plaça de la Estrella"	""	""	""	""	""
"plaza de Topete"	"plaça de Topete"	""	""	""	""	""
"plaza del Hospital"	"plaça del Hospital"	""	""	""	""	""
"Plaza de La Pipa"	"Plaça de La Pipa"	""	""	""	""	""
"plaza de la Misericordia"	"plaça de la Misericordia"	""	""	""	""	""
"plaza doctor Gómez Ulla"	"plaça doctor Gómez Ulla"	""	""	""	""	""
"Plaza Doctor Mas Magro"	"Plaça Doctor Mas Magro"	""	""	""	""	""
"plaza San Juan de Dios"	"plaça San Juan de Dios"	""	""	""	""	""
"plaza de Altozano"	"plaça de Altozano"	""	""	""	""	""
"plaza América"	"plaça América"	""	""	""	""	""
"plaza de la Libertad"	"plaça de la Libertad"	""	""	""	""	""
"plaza Joaquín M. López"	"plaça Joaquín M. López"	""	""	""	""	""
"plaza de la Cruz Roja"	"plaça de la Cruz Roja"	""	""	""	""	""
"Plaza de Felipe González Gómez"	"Plaça de Felipe González Gómez"	""	""	""	""	""
"plaza de Manila"	"plaça de Manila"	""	""	""	""	""
"plaza Padre Esplá"	"plaça Padre Esplá"	""	""	""	""	""
"plaza doctor Carlos Van Der Hofstad"	"plaça doctor Carlos Van Der Hofstad"	""	""	""	""	""
"plaza alcalde Agatángelo Soler"	"plaça alcalde Agatángelo Soler"	""	""	""	""	""
"plaza El Progreso"	"plaça El Progreso"	""	""	""	""	""
"plaza de la Cierva"	"plaça de la Cierva"	""	""	""	""	""
"plaza Juan Pablo II"	"plaça Juan Pablo II"	""	""	""	""	""
"plaza de Las Flores"	"plaça de Las Flores"	""	""	""	""	""
"plaza de la Democracia"	"plaça de la Democracia"	""	""	""	""	""
"Plaza Mediterráneo"	"Plaça Mediterráneo"	""	""	""	""	""
"plaza de Orán"	"plaça de Orán"	""	""	""	""	""
"plaza de Castalla"	"plaça de Castalla"	""	""	""	""	""
"Plaza Médico Antonio Barbero"	"Plaça Médico Antonio Barbero"	""	""	""	""	""
"plaza de la Isleta"	"plaça de la Isleta"	""	""	""	""	""
"plaza Rafael Torres"	"plaça Rafael Torres"	""	""	""	""	""
"plaza Doctor Francisco Antón Vigrana"	"plaça Doctor Francisco Antón Vigrana"	""	""	""	""	""
"Plaza de San Diego"	"Plaça de San Diego"	""	""	""	""	""
"plaza Luís Foglietti"	"plaça Luís Foglietti"	""	""	""	""	""
"plaza de San Diego"	"plaça de San Diego"	""	""	""	""	""
"Plaza"	"Plaza"	""	""	""	""	""
"plaza de España-Verdegás"	"plaça de España-Verdegás"	""	""	""	""	""
"Plaza de San Jaime"	"Plaça de San Jaime"	""	""	""	""	""
"Plaza del Maestro"	"Plaça del Maestro"	""	""	""	""	""
"plaza Lillo Cánovas"	"plaça Lillo Cánovas"	""	""	""	""	""
"plaza Felipe Mallol"	"plaça Felipe Mallol"	""	""	""	""	""
"Plaza del Pilar"	"Plaça del Pilar"	""	""	""	""	""
"plaza Alcalde Felipe Mallol"	"plaça Alcalde Felipe Mallol"	""	""	""	""	""
"plaza Antic Calvari"	"plaça Antic Calvari"	""	""	""	""	""
"plaza Santa Faz"	"plaça Santa Faz"	""	""	""	""	""
"plaza Hort dels Lleons"	"plaça Hort dels Lleons"	""	""	""	""	""
"plaza de la Constitución"	"plaça de la Constitución"	""	""	""	""	""
"plaza de la Comunidad Valenciana"	"plaça de la Comunidad Valenciana"	""	""	""	""	""
"plaza Alcalde Gabriel Molina"	"plaça Alcalde Gabriel Molina"	""	""	""	""	""
"plaza José Sala Pérez"	"plaça José Sala Pérez"	""	""	""	""	""
"Plaza del Campo de la Ordana"	"Plaça del Campo de la Ordana"	""	""	""	""	""
"plaza Pintor Cabrera"	"plaça Pintor Cabrera"	""	""	""	""	""
"Plaza de Beniali"	"Plaça de Beniali"	""	""	""	""	""
"Plaza de la Cruz"	"Plaça de la Cruz"	""	""	""	""	""
"plaza de la Iglesia"	"plaça de la Iglesia"	""	""	""	""	""
"Plaza de la Iglesia"	"Plaça de la Iglesia"	""	""	""	""	""
"Plaza Dura"	"Plaça Dura"	""	""	""	""	""
"Plaza María Muntaner"	"Plaça María Muntaner"	""	""	""	""	""
"Plaza de la Coruña"	"Plaça de la Coruña"	""	""	""	""	""
"plaza de Olof Palme"	"plaça de Olof Palme"	""	""	""	""	""
"Plaza de la Huerta"	"Plaça de la Huerta"	""	""	""	""	""
"Plaza de Poniente"	"Plaça de Poniente"	""	""	""	""	""
"Plaza de Levante"	"Plaça de Levante"	""	""	""	""	""
"Plaza del Ayuntamiento"	"Plaça del Ayuntamiento"	""	""	""	""	""
"Plaza García lorca"	"Plaça García lorca"	""	""	""	""	""
"Plaza Federico García Lorca"	"Plaça Federico García Lorca"	""	""	""	""	""
"Plaza Soledad"	"Plaça Soledad"	""	""	""	""	""
"Plaza de la Constitución"	"Plaça de la Constitución"	""	""	""	""	""
"plaza de la Trinidad"	"plaça de la Trinidad"	""	""	""	""	""
"Plaza del Pescador"	"Plaça del Pescador"	""	""	""	""	""
"Plaza de Crevillent"	"Plaça de Crevillent"					
"Plaza 1º de Mayo"	"Plaça 1º de Mayo"					
"Plaza Barcelona -M. Pastor Sempere"	"Plaça Barcelona -M. Pastor Sempere"					
"Plaza Barcelona"	"Plaça Barcelona"					
"Plaza Jaume I"	"Plaça Jaume I"					
"Plaza Benidorm"	"Plaça Benidorm"					
"Plaza Cardenal Belluga"	"Plaça Cardenal Belluga"					
"Plaza Villa Real"	"Plaça Villa Real"					
"Plaza la Antina"	"Plaça la Antina"					
"Plaza la Iglesia"	"Plaça la Iglesia"					
"Plaza Poeta Macia Abela"	"Plaça Poeta Macia Abela"					
"Plaza Violinista Telmo Vela"	"Plaça Violinista Telmo Vela"					
"Plaza Planelles"	"Plaça Planelles"					
"Plaza Padre Palau"	"Plaça Padre Palau"					
"Plaza Mohamed Al-Shafra"	"Plaça Mohamed Al-Shafra"					
"Plaza Chapí"	"Plaça Chapí"					
"Plaza Doctor Mas Candela"	"Plaça Doctor Mas Candela"					
"Plaza Iglesia Vieja"	"Plaça Iglesia Vieja"					
"plaza del Fester"	"plaça del Fester"					
"plaza Fester"	"plaça Fester"					
"plaza Santísimo Cristo de Zalamea"	"plaça Santísimo Cristo de Zalamea"					
"plaza Marcelino Domingo y San Juan"	"plaça Marcelino Domingo y San Juan"					
"plaza obispo Siuri"	"plaça obispo Siuri"					
"plaza jardín de Aspe"	"plaça jardín de Aspe"					
"Plaza de Benejuza"	"Plaça de Benejuza"					
"plaza de la avenida de Novelda"	"plaça de la avenida de Novelda"					
"plaza avenida de Almansa"	"plaça avenida de Almansa"					
"Plaza del Salvador"	"Plaça del Salvador"					
"plaza Don Julio María López Orozco"	"plaça Don Julio María López Orozco"					
"plaza Benidorm"	"plaça Benidorm"					
"plaza de Benidorm"	"plaça de Benidorm"					
"plaza Rigoberta Menchú"	"plaça Rigoberta Menchú"					
"plaza Bimil·lenari"	"plaça Bimil·lenari"					
"Plaza Palacio de los Deportes"	"Plaça Palacio de los Deportes"					
"plaza avenida del Altet"	"plaça avenida del Altet"					
"plaza Enric Valor"	"plaça Enric Valor"					
"Plaza Enric Valor"	"Plaça Enric Valor"					
"Plaza Ricardo Banegas Gil"	"Plaça Ricardo Banegas Gil"					
"Plaza de los Sauces"	"Plaça de los Sauces"					
"Plaza del Bajo Vinalopó"	"Plaça del Bajo Vinalopó"					
"Plaza de Aitana"	"Plaça de Aitana"					
"Plaza Nati La Modista"	"Plaça Nati La Modista"					
"Plaza del Médico Juan de Dios Pérez Mira"	"Plaça del Médico Juan de Dios Pérez Mira"					
"Plaza central"	"Plaça central"					
"Plaza Nieves Piñol"	"Plaça Nieves Piñol"					
"plaza del Profesor Pepe Belso"	"plaça del Profesor Pepe Belso"					
"Plaza Espana"	"Plaça Espana"					
"Plaza Mariola"	"Plaça Mariola"					
"Plaza Anselmo Martí"	"Plaça Anselmo Martí"					
"Plaza Venerable Escuder"	"Plaça Venerable Escuder"					
"Plaza San Pedro"	"Plaça San Pedro"					
"Plaza del Carmen"	"Plaça del Carmen"					
"Plaza Apostoles"	"Plaça Apostoles"					
"Plaza San Isidro"	"Plaça San Isidro"					
"Plaza San Pablo"	"Plaça San Pablo"					
"Plaza San Roqze"	"Plaça San Roqze"					
"Plaza Esglesia"	"Plaça Esglesia"					
"Plaza l'Era"	"Plaça l'Era"					
"Plaza del Conto"	"Plaça del Conto"					
"Plaza Teresa Gil de Vidaure"	"Plaça Teresa Gil de Vidaure"					
"Plaza Orts Valencianas"	"Plaça Orts Valencianas"					
"Plaza Dr. Fleming"	"Plaça Dr. Fleming"					
"Plaza del convento"	"Plaça del convento"					
"plaza Ferrora"	"plaça Ferrora"					
"plaza de España"	"plaça de España"					
"plaza Mestre Vicente Iborra"	"plaça Mestre Vicente Iborra"					
"plaza Glorieta"	"plaça Glorieta"					
"Plaza San Vicente"	"Plaça San Vicente"					
"Plaza de las Acacias"	"Plaça de las Acacias"					
"Plaza de la Fuente"	"Plaça de la Fuente"					
"Plaza Padre Juan Bautista Domenech"	"Plaça Padre Juan Bautista Domenech"					
"Plaza Pou Madrigal"	"Plaça Pou Madrigal"					
"Plaza Virgen del Roser"	"Plaça Virgen del Roser"					
"Plaza Nueva York"	"Plaça Nueva York"					
"Plaza Reyes Magos"	"Plaça Reyes Magos"					
"Plaza de los Jugueteros"	"Plaça de los Jugueteros"					
"Plaza Nuestra Señora de Lourdes"	"Plaça Nuestra Señora de Lourdes"					
"Plaza Antonio José Cavanilles"	"Plaça Antonio José Cavanilles"					
"Plaza Pedro Luis Cortés"	"Plaça Pedro Luis Cortés"					
"Plaza Sarga"	"Plaça Sarga"					
"Plaza Foia"	"Plaça Foia"					
"Plaza Biar"	"Plaça Biar"					
"Plaza Miguel Delibes"	"Plaça Miguel Delibes"					
"Plaza de las Cortes"	"Plaça de las Cortes"					
"Plaza Palla"	"Plaça Palla"					
"Plaza Centenari del joguet"	"Plaça Centenari del joguet"					
"Plaza Miguel Servet"	"Plaça Miguel Servet"					
"Plaza del Centenari"	"Plaça del Centenari"					
"Plaza l'Església"	"Plaça l'Església"					
"Plaza Teixereta"	"Plaça Teixereta"					
"Plaza Mirasol"	"Plaça Mirasol"					
"Plaza Simarro"	"Plaça Simarro"					
"Plaza de la casa de Andalucía"	"Plaça de la casa de Andalucía"					
"Plaza el Raset"	"Plaça el Raset"					
"Plaza Benisuai"	"Plaça Benisuai"					
"Plaza del Nel"	"Plaça del Nel"					
"Plaza de Colon"	"Plaça de Colon"					
"Plaza Gabriel Miro"	"Plaça Gabriel Miro"					
"Plaza Las Ocas"	"Plaça Las Ocas"					
"Plaza de Sant Anna"	"Plaça de Sant Anna"					
"Plaza d' ESPANYA"	"Plaça d' ESPANYA"					
"Plaza L'EMPEDRAT"	"Plaça L'EMPEDRAT"					
"Plaza la PILOTA"	"Plaça la PILOTA"					
"Plaza Generalitat"	"Plaça Generalitat"					
"Plaza Rei Jaume I"	"Plaça Rei Jaume I"					
"Plaza Ecce Homo"	"Plaça Ecce Homo"					
"Plaza Francisco de Paula"	"Plaça Francisco de Paula"					
"plaza de Cristo"	"plaça de Cristo"					
"Plaza del Cristo"	"Plaça del Cristo"					
"Plaza de las Flores"	"Plaça de las Flores"					
"Plaza Colón"	"Plaça Colón"					
"Plaza de la Virgin del Carmen"	"Plaça de la Virgin del Carmen"					
"Plaza de las Suertes"	"Plaça de las Suertes"					
"Plaza del Palangre"	"Plaça del Palangre"					
"Plaza del Tresmal"	"Plaça del Tresmal"					
"Plaza Mar de Andaman"	"Plaça Mar de Andaman"					
"Plaza del Océano Pacífico"	"Plaça del Océano Pacífico"					
"Plaza Porxes"	"Plaça Porxes"					
"Plaza Assutzena"	"Plaça Assutzena"					
"plaza de la iglesia"	"plaça de la iglesia"					
"Plaza de Dalt"	"Plaça de Dalt"					
"Plaza de Balx"	"Plaça de Balx"					
"Plaza Almirante Bastarreche"	"Plaça Almirante Bastarreche"					
"Plaza de la Escola"	"Plaça de la Escola"					
"plaza de maniobra de vehículos"	"plaça de maniobra de vehículos"					
"Plaza de las Tiendas"	"Plaça de las Tiendas"					
"Plaza de España - Plaça d'Espanya"	"Plaça de España - Plaça d'Espanya"					
"Plaza Ciudad de Manizales"	"Plaça Ciudad de Manizales"					
"Plaza del Infante"	"Plaça del Infante"					
"Plaza de Luna"	"Plaça de Luna"					
"Plaza Unidad Actuación"	"Plaça Unidad Actuación"					
"Plaza del Prelado Antonio Bayona"	"Plaça del Prelado Antonio Bayona"					
"Plaza Doctor Fleming"	"Plaça Doctor Fleming"					
"Plaza de la Hispanidad"	"Plaça de la Hispanidad"					
"Plaza l'Hort de Colón"	"Plaça l'Hort de Colón"					
"Plaza de SS.MM. Los reyes de España"	"Plaça de SS.MM. Los reyes de España"					
"Plaza Mestre de Música Francisco Pérez Devesa"	"Plaça Mestre de Música Francisco Pérez Devesa"					
"Plaza de L'Anoguer"	"Plaça de L'Anoguer"					
"Plaza de Constitucion"	"Plaça de Constitucion"					
"Plaza de Espanya"	"Plaça de Espanya"					
"Plaza del Catxo"	"Plaça del Catxo"					
"Plaza de San Gregorio"	"Plaça de San Gregorio"					
"Plaza Obispo Amigó / Bankia"	"Plaça Obispo Amigó / Bankia"					
"Plaza Del Mercado"	"Plaça Del Mercado"					
"Plaza Redonda Flats"	"Plaça Redonda Flats"					
"Plaza del Negrito"	"Plaça del Negrito"					
"Plaza de la Virgen"	"Plaça de la Virgen"					
"Plaza Sor Guillermina"	"Plaça Sor Guillermina"					
"Plaza Santa Apolonia"	"Plaça Santa Apolonia"					
"Plaza de La Patrona"	"Plaça de La Patrona"					
"Plaza de Sant Vicent Ferrer"	"Plaça de Sant Vicent Ferrer"					
"Plaza la Vila"	"Plaça la Vila"					
"plaza vicent andres estellés"	"plaça vicent andres estellés"					
"Plaza d´Edetania"	"Plaça d´Edetania"					
"Plaza de la Estación"	"Plaça de la Estación"					
"Plaza País Valencià"	"Plaça País Valencià"					
"Plaza De Pablo"	"Plaça De Pablo"					
"Plaza de gátova"	"Plaça de gátova"					
"Plaza de Jaume Roig"	"Plaça de Jaume Roig"					
"Plaza de Partidores"	"Plaça de Partidores"					
"Plaza de Vicente Mañez"	"Plaça de Vicente Mañez"					
"Plaza de Tetuán"	"Plaça de Tetuán"					
"Plaza San Agustín"	"Plaça San Agustín"					
"Plaza Rosario"	"Plaça Rosario"					
"Plaza Gabriel Esteve"	"Plaça Gabriel Esteve"					
"Plaza Ayuntamiento"	"Plaça Ayuntamiento"					
"Plaza Cura Escandell"	"Plaça Cura Escandell"					
"Plaza José Gil"	"Plaça José Gil"					
"Plaza Numero 1, 9042"	"Plaça Numero 1, 9042"					
"Plaza Diputación"	"Plaça Diputación"					
"Plaza Llavant"	"Plaça Llavant"					
"Plaza Villanueva de Castellón"	"Plaça Villanueva de Castellón"					
"Plaza Joaquín Martínez"	"Plaça Joaquín Martínez"					
"Plaza Malves"	"Plaça Malves"					
"Plaza del Rey"	"Plaça del Rey"					
"Plaza Constitució"	"Plaça Constitució"					
"Plaza San Fermín"	"Plaça San Fermín"					
"Plaza de la Generalitat"	"Plaça de la Generalitat"					
"Plaza Valencia C.F."	"Plaça Valencia C.F."					
"Plaza Espanya"	"Plaça Espanya"					
"Plaza Portugal"	"Plaça Portugal"					
"Plaza Maestro Magenti"	"Plaça Maestro Magenti"					
"Plaza Vera"	"Plaça Vera"					
"Plaza Maestro Albuixech"	"Plaça Maestro Albuixech"					
"Plaza Lavadero"	"Plaça Lavadero"					
"Plaza Cuartel"	"Plaça Cuartel"					
"Plaza Salvador Hernández"	"Plaça Salvador Hernández"					
"Plaza José María Ordeig"	"Plaça José María Ordeig"					
"Plaza de la Veritat"	"Plaça de la Veritat"					
"Plaza de les Lletres Valencianes"	"Plaça de les Lletres Valencianes"					
"Plaza Menina"	"Plaça Menina"					
"Plaza Cartonajes"	"Plaça Cartonajes"					
"Plaza Tirant lo Blanc"	"Plaça Tirant lo Blanc"					
"Plaza Pais Valencià"	"Plaça Pais Valencià"					
"Plaza de los milagros"	"Plaça de los milagros"					
"Plaza de Cabanilles"	"Plaça de Cabanilles"					
"Plaza Organista Cabanilles"	"Plaça Organista Cabanilles"					
"Plaza de Alicante"	"Plaça de Alicante"					
"Plaza del Cid"	"Plaça del Cid"					
"Plaza Tres Moreres"	"Plaça Tres Moreres"					
"Plaza del Cid Campeador"	"Plaça del Cid Campeador"					
"Plaza Del Ayuntamiento"	"Plaça Del Ayuntamiento"					
"Plaza del carbón"	"Plaça del carbón"					
"Plaza de Europa"	"Plaça de Europa"					
"Plaza de la Ribera"	"Plaça de la Ribera"					
"Plaza Convento"	"Plaça Convento"	""	""			
"Plaza del Convento"	"Plaça del Convento"	""	""			
"Plaza de la Constitución"	"Plaça de la Constitución"	"Plaça del Ayuntamiento"	"Plaza del Ayuntamiento"			
"Plaza de la Cruz(Plaça de la Creu"	"Plaça de la Cruz(Plaça de la Creu"	""	""			
"Plaza Mesón"	"Plaça Mesón"	""	""			
"Plaza de la Paz"	"Plaça de la Paz"	""	""			
"Plaza aparcamiento minusvalidos"	"Plaça aparcamiento minusvalidos"					
"Plaza Juan Carlos I"	"Plaça Juan Carlos I"					
"Plaza Escandell"	"Plaça Escandell"					
"plaza de la Vaca"	"plaça de la Vaca"					
"Plaza de Novelda"	"Plaça de Novelda"					
"plaza de Gómez Navarro"	"plaça de Gómez Navarro"					
"plaza de Novelda"	"plaça de Novelda"					
"plaza de abastos"	"plaça de abastos"					
"Plaza Doctor Fléming"	"Plaça Doctor Fléming"					
"Plaza San Fernando"	"Plaça San Fernando"					
"Plaza Virgen del Remedio"	"Plaça Virgen del Remedio"					
"Plaza de la Rosaleda"	"Plaça de la Rosaleda"					
"Plaza de la Venta Blai"	"Plaça de la Venta Blai"					
"Plaza del Calvario"	"Plaça del Calvario"					
"Plaza Melchor"	"Plaça Melchor"					
"Plaza la Sala-Conmemoración"	"Plaça la Sala-Conmemoración"					
"Plaza la Sala"	"Plaça la Sala"					
"Plaza de Joaquín Llorente"	"Plaça de Joaquín Llorente"					
"Plaza Elena Fenoll"	"Plaça Elena Fenoll"					
"Plaza Carmen Alborch"	"Plaça Carmen Alborch"					
"plaza San Lázaro"	"plaça San Lázaro"					
"plaza de San Lázaro"	"plaça de San Lázaro"					
"plaza Santa Teresa Jornet"	"plaça Santa Teresa Jornet"					
"Plaza de Pío XII"	"Plaça de Pío XII"					
"plaza de Pío XII"	"plaça de Pío XII"					
"plaza Pais Valencià"	"plaça Pais Valencià"					
"plaza de la cruz"	"plaça de la cruz"					
"Plaza Joan Fuster"	"Plaça Joan Fuster"					
"plaza de la Magdalena"	"plaça de la Magdalena"					
"plaza del Cementerio Viejo"	"plaça del Cementerio Viejo"					
"Plaza Margarita Salas"	"Plaça Margarita Salas"					
"Plaza Asamblea Amistosa Literaria"	"Plaça Asamblea Amistosa Literaria"					
"Plaza de los Trabajadores del Azafrán"	"Plaça de los Trabajadores del Azafrán"					
"Plaza de los Trabajadores de la Uva"	"Plaça de los Trabajadores de la Uva"					
"Plaza de la Fuente del Sacristà"	"Plaça de la Fuente del Sacristà"					
"Plaza de la Gilma"	"Plaça de la Gilma"					
"Plaza Alcalde José Bernabé"	"Plaça Alcalde José Bernabé"					
"Plaza Pescadores"	"Plaça Pescadores"					
"Plaza Virgen del Carmen"	"Plaça Virgen del Carmen"					
