"name"	"name:ca"	"alt_name:ca"	"alt_name"	"translations"	"ca.wikipedia_page"	"wikidata_type"	"wikidata_id"
"calle Mistral"	"carrer Mistral"	""	""				
"Calle Médico Vicente Reyes, 15"	"Carrer Médico Vicente Reyes, 15"	""	""				
"Calle Médico Vicente Reyes, 22"	"Carrer Médico Vicente Reyes, 22"	""	""				
"calle de la Caja de Ahorros"	"carrer de la Caja de Ahorros"	""	""				
"Calle Hogar Provincial, 6"	"Carrer Hogar Provincial, 6"	""	""				
"calle Petrer - jijona"	"carrer Petrer - jijona"	""	""				
"Calle San Vicente, 46"	"Carrer San Vicente, 46"	""	""				
"Calle San Bartolomé, 78"	"Carrer San Bartolomé, 78"	""	""				
"Calle Gaviota"	"Carrer Gaviota"	""	""				
"Calle Torreón"	"Carrer Torreón"	""	""				
"calle La Altura"	"carrer La Altura"	""	""				
"calle de la Gubia"	"carrer de la Gubia"	""	""				
"calle de La Loma"	"carrer de La Loma"	""	""				
"calle de las Casillas"	"carrer de las Casillas"	""	""				
"calle Sierra de Salinas"	"carrer Sierra de Salinas"	""	""				
"calle Sierra de Benejama"	"carrer Sierra de Benejama"	""	""				
"calle Sierra Xortà"	"carrer Sierra Xortà"	""	""				
"calle Sierra de la Grana"	"carrer Sierra de la Grana"	""	""				
"calle de la Zarza"	"carrer de la Zarza"	""	""				
"calle de la la Sierra"	"carrer de la la Sierra"	""	""				
"calle de la Cima"	"carrer de la Cima"	""	""				
"calle de Poniente"	"carrer de Poniente"	""	""				
"calle Caliseira"	"carrer Caliseira"	""	""				
"calle Sierra de la Safor"	"carrer Sierra de la Safor"	""	""				
"calle Sierra de Benicadell"	"carrer Sierra de Benicadell"	""	""				
"calle Almenaras-Xeperut"	"carrer Almenaras-Xeperut"	""	""				
"calle Torre-Xeperut"	"carrer Torre-Xeperut"	""	""				
"calle Lo Xeperut"	"carrer Lo Xeperut"	""	""				
"calle de la Peña"	"carrer de la Peña"	""	""				
"calle del Lago"	"carrer del Lago"	""	""				
"calle Benijófar"	"carrer Benijófar"	""	""				
"calle Benimeli"	"carrer Benimeli"	""	""				
"calle Canals"	"carrer Canals"	""	""				
"calle Antella"	"carrer Antella"	""	""				
"calle Tárbena"	"carrer Tárbena"	""	""				
"Calle Tomillo"	"Carrer Tomillo"	""	""				
"Calle Maiz"	"Carrer Maiz"	""	""				
"Calle del Genario"	"Carrer del Genario"	""	""				
"Calle Laurel"	"Carrer Laurel"	""	""				
"calle Rosa de los Vientos"	"carrer Rosa de los Vientos"	""	""				
"calle Llano del Espartal"	"carrer Llano del Espartal"	""	""				
"calle de La Serranía"	"carrer de La Serranía"	""	""				
"calle del Arenal"	"carrer del Arenal"	""	""				
"calle del Pincel"	"carrer del Pincel"	""	""				
"calle de la Trinchera"	"carrer de la Trinchera"	""	""				
"calle de la Luz"	"carrer de la Luz"	""	""				
"calle de Correos"	"carrer de Correos"	""	""				
"calle La Peletería"	"carrer La Peletería"	""	""				
"calle Cristal"	"carrer Cristal"	""	""				
"calle Sierra del Almirante"	"carrer Sierra del Almirante"	""	""				
"calle Colegio"	"carrer Colegio"	""	""				
"calle de Los Bolos"	"carrer de Los Bolos"	""	""				
"calle Regidor"	"carrer Regidor"	""	""				
"calle Sierra de Alfaro"	"carrer Sierra de Alfaro"	""	""				
"calle Sierra del Reclot"	"carrer Sierra del Reclot"	""	""				
"calle Sierra Helada"	"carrer Sierra Helada"	""	""				
"calle Sierra Nevada"	"carrer Sierra Nevada"	""	""				
"calle Sierra de Segària"	"carrer Sierra de Segària"	""	""				
"calle del Barranco del Lobo"	"carrer del Barranco del Lobo"	""	""				
"calle Ermita de San Jaime"	"carrer Ermita de San Jaime"	""	""				
"calle de La Montaña"	"carrer de La Montaña"	""	""				
"calle del Reble"	"carrer del Reble"	""	""				
"calle Sierra de Fontcalent"	"carrer Sierra de Fontcalent"	""	""				
"calle Lo Gosalvez"	"carrer Lo Gosalvez"	""	""				
"calle del Ripio"	"carrer del Ripio"	""	""				
"calle Lo Sogorb"	"carrer Lo Sogorb"	""	""				
"calle Miguel Nomdedeu"	"carrer Miguel Nomdedeu"	""	""				
"calle Aviación Torregrosa"	"carrer Aviación Torregrosa"	""	""				
"calle Montaut"	"carrer Montaut"	""	""				
"calle Cantera"	"carrer Cantera"	""	""				
"calle Bonanza"	"carrer Bonanza"	""	""				
"calle nº 11"	"carrer nº 11"	""	""				
"calle Arco Iris"	"carrer Arco Iris"	""	""				
"calle Guillermo Stewart Howie"	"carrer Guillermo Stewart Howie"	""	""				
"calle Aurora Boreal"	"carrer Aurora Boreal"	""	""				
"calle Agua"	"carrer Agua"	""	""				
"calle Alísios"	"carrer Alísios"	""	""				
"calle Viento"	"carrer Viento"	""	""				
"calle Trueno"	"carrer Trueno"	""	""				
"calle Nieve"	"carrer Nieve"	""	""				
"calle Granizo"	"carrer Granizo"	""	""				
"calle nº 8"	"carrer nº 8"	""	""				
"calle Agamenón"	"carrer Agamenón"	""	""				
"calle Telémaco"	"carrer Telémaco"	""	""				
"calle Nestor"	"carrer Nestor"	""	""				
"calle Ítaca"	"carrer Ítaca"	""	""				
"calle Ulises"	"carrer Ulises"	""	""				
"calle Homero"	"carrer Homero"	""	""				
"calle Minerva"	"carrer Minerva"	""	""				
"calle Juno"	"carrer Juno"	""	""				
"calle Penélope"	"carrer Penélope"	""	""				
"calle Meteorito"	"carrer Meteorito"	""	""				
"calle vial de los cipreses"	"carrer vial de los cipreses"	""	""				
"calle arquitecto Miguel de Real"	"carrer arquitecto Miguel de Real"	""	""				
"calle del Llano del Espartal"	"carrer del Llano del Espartal"	""	""				
"calle arquitecto Miguel del Real"	"carrer arquitecto Miguel del Real"	""	""				
"calle río Turia"	"carrer río Turia"	""	""				
"calle Cielo"	"carrer Cielo"	""	""				
"calle San Pedro de Alcántara"	"carrer San Pedro de Alcántara"	""	""				
"calle San Emilio"	"carrer San Emilio"	""	""				
"calle de la Samaritana"	"carrer de la Samaritana"	""	""				
"calle San Javier"	"carrer San Javier"	""	""				
"calle Pino"	"carrer Pino"	""	""				
"calle Hermes"	"carrer Hermes"	""	""				
"calle Aguamarina"	"carrer Aguamarina"	""	""				
"calle Aligustre"	"carrer Aligustre"	""	""				
"calle Nandina"	"carrer Nandina"	""	""				
"calle Ricino"	"carrer Ricino"	""	""				
"calle de la Choisia"	"carrer de la Choisia"	""	""				
"calle Aucuba"	"carrer Aucuba"	""	""				
"calle Abelia"	"carrer Abelia"	""	""				
"calle Cornejo"	"carrer Cornejo"	""	""				
"calle Acebo"	"carrer Acebo"	""	""				
"calle Fatsia"	"carrer Fatsia"	""	""				
"calle del Avellano"	"carrer del Avellano"	""	""				
"calle Casia"	"carrer Casia"	""	""				
"calle Lugar Finca Evangelio"	"carrer Lugar Finca Evangelio"	""	""				
"calle Azalea"	"carrer Azalea"	""	""				
"calle Orquídea"	"carrer Orquídea"	""	""				
"calle Granado"	"carrer Granado"	""	""				
"calle Lila"	"carrer Lila"	""	""				
"calle de los Montoyos"	"carrer de los Montoyos"	""	""				
"Calle Bretón de los Herreros"	"Carrer Bretón de los Herreros"	""	""				
"calle de la Fábrica de Cementos"	"carrer de la Fábrica de Cementos"	""	""				
"calle de los Artistas Falleros"	"carrer de los Artistas Falleros"	""	""				
"calle Tormos"	"carrer Tormos"	""	""				
"calle Orba"	"carrer Orba"	""	""				
"Calle Agua Amarga"	"Carrer Agua Amarga"	""	""				
"calle de Ramón Gómez Sempere"	"carrer de Ramón Gómez Sempere"	""	""				
"calle de Pedreguer"	"carrer de Pedreguer"	""	""				
"calle Buenavista"	"carrer Buenavista"	""	""				
"calle de los Cincuenta"	"carrer de los Cincuenta"	""	""				
"calle deportista Joaquín Blume"	"carrer deportista Joaquín Blume"	""	""				
"calle María Guerrero"	"carrer María Guerrero"	""	""				
"calle San Gabriel"	"carrer San Gabriel"	""	""				
"calle Amistad"	"carrer Amistad"	""	""				
"calle Fernando Díaz Mendoza"	"carrer Fernando Díaz Mendoza"	""	""				
"calle Adrián Pastor"	"carrer Adrián Pastor"	""	""				
"calle de Villena"	"carrer de Villena"	""	""				
"calle Pego"	"carrer Pego"	""	""				
"calle la Era"	"carrer la Era"	""	""				
"calle Armonía"	"carrer Armonía"	""	""				
"calle Doce Puentes"	"carrer Doce Puentes"	""	""				
"calle Torre Gadea"	"carrer Torre Gadea"	""	""				
"calle músico José Alcaráz Pérez"	"carrer músico José Alcaráz Pérez"	""	""				
"calle Moraira"	"carrer Moraira"	""	""				
"calle del Muro"	"carrer del Muro"	""	""				
"calle Cocentaina"	"carrer Cocentaina"	""	""				
"calle ebanistería"	"carrer ebanistería"	""	""				
"calle de las comunicaciones"	"carrer de las comunicaciones"	""	""				
"Calle Rincón de León"	"Carrer Rincón de León"	""	""				
"calle Julián Besteiro"	"carrer Julián Besteiro"	""	""				
"calle Vicente Chávarri"	"carrer Vicente Chávarri"	""	""				
"calle Rafael Escolano"	"carrer Rafael Escolano"	""	""				
"calle Vergel"	"carrer Vergel"	""	""				
"calle Callosa d'Ensarriá"	"carrer Callosa d'Ensarriá"	""	""				
"calle Ecuador"	"carrer Ecuador"	""	""				
"calle catedrático Lafuente Vidal"	"carrer catedrático Lafuente Vidal"	""	""				
"calle Comercio"	"carrer Comercio"	""	""				
"calle de los Transportes"	"carrer de los Transportes"	""	""				
"calle Juan Bautista Lafora"	"carrer Juan Bautista Lafora"	""	""				
"calle de la República Argentina"	"carrer de la República Argentina"	""	""				
"calle San Lorenzo"	"carrer San Lorenzo"	""	""				
"calle Centauro"	"carrer Centauro"	""	""				
"calle farmacéutico Ángel Establier"	"carrer farmacéutico Ángel Establier"	""	""				
"calle río Júcar"	"carrer río Júcar"	""	""				
"calle Lliber"	"carrer Lliber"	""	""				
"calle publicista Antonio Bernabéu"	"carrer publicista Antonio Bernabéu"	""	""				
"calle Castor"	"carrer Castor"	""	""				
"calle SCD Betis Florida"	"carrer SCD Betis Florida"	""	""				
"calle Arturo"	"carrer Arturo"	""	""				
"calle camino viejo de Elche"	"carrer camino viejo de Elche"	""	""				
"calle la Flor"	"carrer la Flor"	""	""				
"calle de Aigües"	"carrer de Aigües"	""	""				
"calle Méjico"	"carrer Méjico"	""	""				
"calle Méjico"	"carrer Méjico"	""	"Gran Vía"				
"calle Club de Fútbol Hércules"	"carrer Club de Fútbol Hércules"	""	""				
"calle Fernando Madroñal"	"carrer Fernando Madroñal"	""	""				
"calle Pardo Jimeno"	"carrer Pardo Jimeno"	""	""				
"calle Arquitecto Guardiola"	"carrer Arquitecto Guardiola"	""	""				
"calle Alberola"	"carrer Alberola"	""	""				
"calle San Agatángelo"	"carrer San Agatángelo"	""	""				
"calle Capitán Dema"	"carrer Capitán Dema"	""	""				
"calle de los Doscientos"	"carrer de los Doscientos"	""	""				
"calle Periodista Rafael González Aguilar"	"carrer Periodista Rafael González Aguilar"	""	""				
"calle Enriqueta Elizaicin"	"carrer Enriqueta Elizaicin"	""	""				
"callejón la conserva"	"callejón la conserva"	""	""				
"calle Llop Mari"	"carrer Llop Mari"	""	""				
"calle Quintiliano"	"carrer Quintiliano"	""	""				
"calle banda de música Los Claveles"	"carrer banda de música Los Claveles"	""	""				
"calle astrónomo Comas Solá"	"carrer astrónomo Comas Solá"	""	""				
"calle Santa María Mazzarello"	"carrer Santa María Mazzarello"	""	""				
"calle José Salvetti"	"carrer José Salvetti"	""	""				
"Calle Hermanos Machado"	"Carrer Hermanos Machado"	""	""				
"calle Gonzalo Soriano"	"carrer Gonzalo Soriano"	""	"Gran Vía"				
"calle actor Arturo Lledó"	"carrer actor Arturo Lledó"	""	""				
"calle farmacéutico Luis Gisbert"	"carrer farmacéutico Luis Gisbert"	""	""				
"Calle Nuevo Babel"	"Carrer Nuevo Babel"	""	""				
"calle padre Cerdá"	"carrer padre Cerdá"	""	""				
"calle de Dominguez Margarit"	"carrer de Dominguez Margarit"	""	""				
"calle José Gil Muñoz"	"carrer José Gil Muñoz"	""	""				
"calle Dominguez Margarit"	"carrer Dominguez Margarit"	""	""				
"calle del alcalde José Luis Lassaleta"	"carrer del alcalde José Luis Lassaleta"	""	""				
"calle nadadora Carmen Soto"	"carrer nadadora Carmen Soto"	""	""				
"calle Francisco Muñoz Llorens"	"carrer Francisco Muñoz Llorens"	""	""				
"calle canónigo Galbis"	"carrer canónigo Galbis"	""	""				
"calle Pavía"	"carrer Pavía"	""	""				
"calle Núñez de Arce"	"carrer Núñez de Arce"	""	""				
"calle del Capitán Dema"	"carrer del Capitán Dema"	""	""				
"calle de González Ortiz"	"carrer de González Ortiz"	""	""				
"calle de Rubén Darío"	"carrer de Rubén Darío"	""	""				
"calle de Eduardo Marquina"	"carrer de Eduardo Marquina"	""	""				
"calle del Arquitecto Guardiola"	"carrer del Arquitecto Guardiola"	""	""				
"calle Moreto"	"carrer Moreto"	""	""				
"Calle de Eduardo Marquina"	"Carrer de Eduardo Marquina"	""	""				
"Calle Arzobispo Loaces"	"Carrer Arzobispo Loaces"	""	""				
"calle de Alona"	"carrer de Alona"	""	""				
"calle Doctor Just"	"carrer Doctor Just"	""	""				
"calle Pérez Medina"	"carrer Pérez Medina"	""	""				
"calle Heliodoro Madrona"	"carrer Heliodoro Madrona"	""	""				
"calle de Manuel Sala"	"carrer de Manuel Sala"	""	""				
"calle Profesor Manuel Sala"	"carrer Profesor Manuel Sala"	""	""				
"calle García Andreu"	"carrer García Andreu"	""	""				
"calle Muelle de Poniente"	"carrer Muelle de Poniente"	""	""				
"calle Ab El Hamet"	"carrer Ab El Hamet"	""	""				
"calle Leo"	"carrer Leo"	""	""				
"calle abogado Andrés Charques"	"carrer abogado Andrés Charques"	""	""				
"calle de la Vega"	"carrer de la Vega"	""	""				
"calle Río Muni"	"carrer Río Muni"	""	""				
"calle Poeta Pastor"	"carrer Poeta Pastor"	""	""				
"calle prolongación Santa Cecilia"	"carrer prolongación Santa Cecilia"	""	""				
"calle de la Constelación"	"carrer de la Constelación"	""	""				
"calle Perseo"	"carrer Perseo"	""	""				
"calle Vicente Bonastre"	"carrer Vicente Bonastre"	""	""				
"calle Pegaso"	"carrer Pegaso"	""	""				
"calle Ana Navarro"	"carrer Ana Navarro"	""	""				
"calle Pólux"	"carrer Pólux"	""	""				
"calle Sirio"	"carrer Sirio"	""	""				
"calle Cástor"	"carrer Cástor"	""	""				
"calle Vall de Laguart"	"carrer Vall de Laguart"	""	""				
"calle general Varela"	"carrer general Varela"	""	""				
"calle Águila"	"carrer Águila"	""	""				
"calle Omega"	"carrer Omega"	""	""				
"Calle Cefeo"	"Carrer Cefeo"	""	""				
"calle Jaime Niñoles"	"carrer Jaime Niñoles"	""	""				
"calle Tomás Aznar Domenech"	"carrer Tomás Aznar Domenech"	""	""				
"calle Régulo"	"carrer Régulo"	""	""				
"calle prolongación Pegaso"	"carrer prolongación Pegaso"	""	""				
"calle Rigell"	"carrer Rigell"	""	""				
"calle Cafeo"	"carrer Cafeo"	""	""				
"Calle virgen de Fátima"	"Carrer virgen de Fátima"	""	""				
"calle José López Agudo"	"carrer José López Agudo"	""	""				
"calle Alfa"	"carrer Alfa"	""	""				
"Calle Hermanos Bernard"	"Carrer Hermanos Bernard"	""	""				
"calle Benejama"	"carrer Benejama"	""	""				
"calle de Grado"	"carrer de Grado"	""	""				
"calle del Cisne"	"carrer del Cisne"	""	""				
"Calle Proción"	"Carrer Proción"	""	""				
"calle Victoriano Ximénez de Couder"	"carrer Victoriano Ximénez de Couder"	""	""				
"calle Antares"	"carrer Antares"	""	""				
"calle Hércules"	"carrer Hércules"	""	""				
"calle Eduardo Langucha"	"carrer Eduardo Langucha"	""	""				
"calle Algol"	"carrer Algol"	""	""				
"calle Virgen de África"	"carrer Virgen de África"	""	""				
"calle Sagitario"	"carrer Sagitario"	""	""				
"calle Borja"	"carrer Borja"	""	""				
"calle Juan Pamblanco Ayela"	"carrer Juan Pamblanco Ayela"	""	""				
"calle doctora Damiana Zaragoza"	"carrer doctora Damiana Zaragoza"	""	""				
"calle practicante Juan Caturla Gosálvez"	"carrer practicante Juan Caturla Gosálvez"	""	""				
"calle Prudencio de la Viña"	"carrer Prudencio de la Viña"	""	""				
"Calle Leon XIII"	"Carrer Leon XIII"	""	""				
"calle deportista César Porcel"	"carrer deportista César Porcel"	""	""				
"calle Tauro"	"carrer Tauro"	""	""				
"calle Virgen del Valle"	"carrer Virgen del Valle"	""	""				
"calle matrona María de Gracia Cases Penad"	"carrer matrona María de Gracia Cases Penad"	""	""				
"calle médico Luis Rivera"	"carrer médico Luis Rivera"	""	""				
"calle médico José Maroto"	"carrer médico José Maroto"	""	""				
"calle ATS Pascual Ruiz Galiano"	"carrer ATS Pascual Ruiz Galiano"	""	""				
"calle médico Eugenio de la Cruz"	"carrer médico Eugenio de la Cruz"	""	""				
"calle Virgen de Guadalupe"	"carrer Virgen de Guadalupe"	""	""				
"calle conde de Casas Rojas"	"carrer conde de Casas Rojas"	""	"Gran Vía"				
"calle de Boyero"	"carrer de Boyero"	""	""				
"calle Aries"	"carrer Aries"	""	""				
"calle profesor David Noguera"	"carrer profesor David Noguera"	""	""				
"calle capitán Adolfo Payá"	"carrer capitán Adolfo Payá"	""	""				
"calle periodista Espinosa Echev"	"carrer periodista Espinosa Echev"	""	""				
"calle Piscis"	"carrer Piscis"	""	""				
"calle Cruz del Sur"	"carrer Cruz del Sur"	""	""				
"calle Lira"	"carrer Lira"	""	""				
"calle Escorpión"	"carrer Escorpión"	""	""				
"calle Cassiopea"	"carrer Cassiopea"	""	""				
"calle Aldebarán"	"carrer Aldebarán"	""	""				
"calle Prudencio la Viña"	"carrer Prudencio la Viña"	""	""				
"calle conde de Casas Rojas"	"carrer conde de Casas Rojas"	""	""				
"calle Conde de Casas Roja"	"carrer Conde de Casas Roja"	""	""				
"calle doctor Santaolalla"	"carrer doctor Santaolalla"	""	""				
"calle de Benillup"	"carrer de Benillup"	""	""				
"calle Bono Guarner"	"carrer Bono Guarner"	""	""				
"calle Virgen de Lourdes"	"carrer Virgen de Lourdes"	""	""				
"calle Francisco Escolano"	"carrer Francisco Escolano"	""	""				
"calle Pascual Orozco"	"carrer Pascual Orozco"	""	""				
"calle médico Pedro Herrero"	"carrer médico Pedro Herrero"	""	""				
"calle deportista Vicente Jordá"	"carrer deportista Vicente Jordá"	""	""				
"calle deportista Vicente Pastor"	"carrer deportista Vicente Pastor"	""	""				
"calle deportista Enrique Carey"	"carrer deportista Enrique Carey"	""	""				
"calle del Club Natación"	"carrer del Club Natación"	""	""				
"calle deportista Ángel Aznar"	"carrer deportista Ángel Aznar"	""	""				
"calle Renato Bardín"	"carrer Renato Bardín"	""	""				
"calle profesores hermanos Muñoz"	"carrer profesores hermanos Muñoz"	""	""				
"calle deportista Benjamín Rodríguez"	"carrer deportista Benjamín Rodríguez"	""	""				
"calle radiofonista Álvarez Antón"	"carrer radiofonista Álvarez Antón"	""	""				
"calle Princesa Mercedes"	"carrer Princesa Mercedes"	""	""				
"calle de Benasau"	"carrer de Benasau"	""	""				
"calle Escultores hermanos Blanco"	"carrer Escultores hermanos Blanco"	""	""				
"calle Gaspar Tato"	"carrer Gaspar Tato"	""	""				
"calle de Alcalá"	"carrer de Alcalá"	""	""				
"calle Carratalá"	"carrer Carratalá"	""	""				
"calle San Raimundo"	"carrer San Raimundo"	""	""				
"calle foguerer Tomás Valcárcel Deza"	"carrer foguerer Tomás Valcárcel Deza"	""	""				
"calle Barraquer"	"carrer Barraquer"	""	""				
"calle Asunción"	"carrer Asunción"	""	""				
"calle concejal Lorenzo Llaneras"	"carrer concejal Lorenzo Llaneras"	""	""				
"calle maestro Latorre"	"carrer maestro Latorre"	""	""				
"calle médico Antonio Arroyo"	"carrer médico Antonio Arroyo"	""	""				
"calle San Marcelino de Champagnat"	"carrer San Marcelino de Champagnat"	""	""				
"calle Pontevedra"	"carrer Pontevedra"	""	""				
"calle padre Recaredo de los Ríos"	"carrer padre Recaredo de los Ríos"	""	""				
"calle capitán general Gutierrez Mellado"	"carrer capitán general Gutierrez Mellado"	""	""				
"calle de Ausó y Monzó"	"carrer de Ausó y Monzó"	""	"Gran Vía"				
"calle Rigoberto Ferrer"	"carrer Rigoberto Ferrer"	""	""				
"calle Guadalest"	"carrer Guadalest"	""	""				
"calle doctora Matilde Pérez Jover"	"carrer doctora Matilde Pérez Jover"	""	""				
"calle médico Manuel Alberola"	"carrer médico Manuel Alberola"	""	""				
"calle enfermera Angelina Ceballos Quintanal"	"carrer enfermera Angelina Ceballos Quintanal"	""	""				
"calle médico Enrique Carratalá"	"carrer médico Enrique Carratalá"	""	""				
"calle médico Andrés Boldó"	"carrer médico Andrés Boldó"	""	""				
"calle hermano Felicísimo Ruiz"	"carrer hermano Felicísimo Ruiz"	""	""				
"calle médico Pérez Martorell"	"carrer médico Pérez Martorell"	""	""				
"calle médico Pedro Orts"	"carrer médico Pedro Orts"	""	""				
"calle padre Recadero de los Ríos"	"carrer padre Recadero de los Ríos"	""	""				
"calle Miraflor"	"carrer Miraflor"	""	""				
"Calle Concejal Lorenzo Llaneras"	"Carrer Concejal Lorenzo Llaneras"	""	""				
"calle Unidad"	"carrer Unidad"	""	""				
"calle Ciudad de Matanzas"	"carrer Ciudad de Matanzas"	""	""				
"calle ciudad de Herzliya"	"carrer ciudad de Herzliya"	""	""				
"calle ciudad de Riga"	"carrer ciudad de Riga"	""	""				
"calle doctor Marañón"	"carrer doctor Marañón"	""	""				
"calle Blas de Lezo"	"carrer Blas de Lezo"	""	""				
"calle Onil"	"carrer Onil"	""	""				
"calle San Matías"	"carrer San Matías"	""	""				
"calle de Santa Pola"	"carrer de Santa Pola"	""	"Gran Vía"				
"calle Campo de Mirra"	"carrer Campo de Mirra"	""	""				
"calle Deportista Pitu Perramón"	"carrer Deportista Pitu Perramón"	""	""				
"calle La Nucia"	"carrer La Nucia"	""	""				
"calle Legazpi"	"carrer Legazpi"	""	""				
"calle Alvarado"	"carrer Alvarado"	""	""				
"calle Agustín Santoja"	"carrer Agustín Santoja"	""	""				
"calle Suiza"	"carrer Suiza"	""	""				
"calle Busot"	"carrer Busot"	""	""				
"calle de la Tubería"	"carrer de la Tubería"	""	""				
"calle Jávea"	"carrer Jávea"	""	""				
"calle Nuestra Señora de los Ángeles"	"carrer Nuestra Señora de los Ángeles"	""	""				
"calle Ollería"	"carrer Ollería"	""	""				
"calle Virgen del Puig"	"carrer Virgen del Puig"	""	""				
"Calle Virgen de la Paz"	"Carrer Virgen de la Paz"	""	""				
"calle Virgen de las Virtudes"	"carrer Virgen de las Virtudes"	""	""				
"calle doctor Recasens"	"carrer doctor Recasens"	""	""				
"calle San Gregorio"	"carrer San Gregorio"	""	""				
"calle Caracas"	"carrer Caracas"	""	""				
"calle Ruiz de Alarcón"	"carrer Ruiz de Alarcón"	""	""				
"calle Vasco de Gama"	"carrer Vasco de Gama"	""	""				
"calle pintor Varela"	"carrer pintor Varela"	""	""				
"calle Bolivia"	"carrer Bolivia"	""	""				
"calle Juan Alemany"	"carrer Juan Alemany"	""	""				
"calle Juan Alemany Limiñana"	"carrer Juan Alemany Limiñana"	""	""				
"calle Pilar de la Horadada"	"carrer Pilar de la Horadada"	""	""				
"calle José Luis Masiá"	"carrer José Luis Masiá"	""	""				
"calle José Antonio Berenguer"	"carrer José Antonio Berenguer"	""	""				
"calle Amadeo Valls"	"carrer Amadeo Valls"	""	""				
"calle Samaniego"	"carrer Samaniego"	""	""				
"calle padre Villafranca"	"carrer padre Villafranca"	""	""				
"calle Jacinto Verdaguer"	"carrer Jacinto Verdaguer"	""	""				
"calle duque de Alba"	"carrer duque de Alba"	""	""				
"calle Ramón de Saavedra"	"carrer Ramón de Saavedra"	""	""				
"calle Mosen Pedro Mena"	"carrer Mosen Pedro Mena"	""	""				
"Calle doctor Maestro de San Juan"	"Carrer doctor Maestro de San Juan"	""	""				
"calle madre Elisea Oliver"	"carrer madre Elisea Oliver"	""	""				
"calle mosen Fenollar"	"carrer mosen Fenollar"	""	""				
"calle Tuberia"	"carrer Tuberia"	""	""				
"calle San Quintin"	"carrer San Quintin"	""	""				
"calle Ondara"	"carrer Ondara"	""	""				
"calle Confrides"	"carrer Confrides"	""	""				
"calle Virgen del Rocío"	"carrer Virgen del Rocío"	""	""				
"calle Ventura la Vega"	"carrer Ventura la Vega"	""	""				
"calle Ponce de León - calle doctor Recasens"	"carrer Ponce de León - carrer doctor Recasens"	""	""				
"calle Javier Cabo"	"carrer Javier Cabo"	""	""				
"calle Castellar"	"carrer Castellar"	""	""				
"calle Serrano"	"carrer Serrano"	""	""				
"calle general Lacy"	"carrer general Lacy"	""	""				
"calle Tucumán"	"carrer Tucumán"	""	""				
"calle catedrático Ferre Vidiella"	"carrer catedrático Ferre Vidiella"	""	""				
"calle catedrático Senante Laudes"	"carrer catedrático Senante Laudes"	""	""				
"calle San Bosco"	"carrer San Bosco"	""	""				
"calle del maestro Marqués"	"carrer del maestro Marqués"	""	""				
"calle Tato"	"carrer Tato"	""	""				
"calle Carlota Pasaron"	"carrer Carlota Pasaron"	""	""				
"calle Enriqueta Ortega"	"carrer Enriqueta Ortega"	""	""				
"calle cardenal Belluga"	"carrer cardenal Belluga"	""	""				
"calle de la Unión"	"carrer de la Unión"	""	""				
"calle Carmen Tato"	"carrer Carmen Tato"	""	""				
"calle Belfast"	"carrer Belfast"	""	""				
"calle Callosa del Segura"	"carrer Callosa del Segura"	""	""				
"calle Juan Ortega"	"carrer Juan Ortega"	""	""				
"calle Alcalde Ramón Hernández"	"carrer Alcalde Ramón Hernández"	""	""				
"calle Joaquín Orozco"	"carrer Joaquín Orozco"	""	""				
"calle María Nomdedéu"	"carrer María Nomdedéu"	""	""				
"calle Rabasa"	"carrer Rabasa"	""	""				
"calle pintor Gisbert"	"carrer pintor Gisbert"	""	""				
"calle Luis Sancho Octavio de Toledo"	"carrer Luis Sancho Octavio de Toledo"	""	""				
"calle pintor Cabrera"	"carrer pintor Cabrera"	""	""				
"calle cardenal Payá"	"carrer cardenal Payá"	""	""				
"calle Segura"	"carrer Segura"	""	""				
"calle Berenguer Marquina"	"carrer Berenguer Marquina"	""	""				
"calle Álvarez Sereix"	"carrer Álvarez Sereix"	""	""				
"calle del Teatro"	"carrer del Teatro"	""	""				
"calle Bazán"	"carrer Bazán"	""	""				
"calle Susana Llaneras"	"carrer Susana Llaneras"	""	""				
"calle Valdés de las Navas"	"carrer Valdés de las Navas"	""	""				
"calle Castaños"	"carrer Castaños"	""	""				
"calle pintor Agrasot"	"carrer pintor Agrasot"	""	""				
"calle Jerusalem"	"carrer Jerusalem"	""	""				
"calle Valdés"	"carrer Valdés"	""	""				
"calle Barón de Finestrat"	"carrer Barón de Finestrat"	""	""				
"calle Humorista Gráfico Forges"	"carrer Humorista Gráfico Forges"	""	""				
"calle Rafael Terol"	"carrer Rafael Terol"	""	""				
"calle Velarde"	"carrer Velarde"	""	""				
"calle Antonio Lanuza"	"carrer Antonio Lanuza"	""	""				
"calle Canalejas"	"carrer Canalejas"	""	""				
"calle Pascual Blanco"	"carrer Pascual Blanco"	""	""				
"calle médico Pascual Pérez"	"carrer médico Pascual Pérez"	""	""				
"calle Limones"	"carrer Limones"	""	""				
"calle de Ojeda"	"carrer de Ojeda"	""	""				
"calle Ángel Lozano"	"carrer Ángel Lozano"	""	""				
"calle general O'Donnell"	"carrer general O'Donnell"	""	""				
"calle Poeta Vila y Blanco"	"carrer Poeta Vila y Blanco"	""	""				
"calle maestro Caballero"	"carrer maestro Caballero"	""	""				
"calle Juan de Herrera"	"carrer Juan de Herrera"	""	""				
"calle Maestro Barbieri"	"carrer Maestro Barbieri"	""	""				
"calle maestro Marqués"	"carrer maestro Marqués"	""	""				
"calle Belando"	"carrer Belando"	""	""				
"calle Manuel Antón"	"carrer Manuel Antón"	""	""				
"calle general Shelly"	"carrer general Shelly"	""	""				
"calle escultor Bañuls"	"carrer escultor Bañuls"	""	""				
"calle López Torregrosa"	"carrer López Torregrosa"	""	""				
"calle pintor Sorolla"	"carrer pintor Sorolla"	""	""				
"calle Duque de Zaragoza"	"carrer Duque de Zaragoza"	""	""				
"calle alférez Díaz Sanchís"	"carrer alférez Díaz Sanchís"	""	""				
"calle San Fernando"	"carrer San Fernando"	""	""				
"calle Cándida Gimeno Gargallo"	"carrer Cándida Gimeno Gargallo"	""	""				
"calle Villegas"	"carrer Villegas"	""	""				
"calle José María Py"	"carrer José María Py"	""	""				
"calle Dagniol"	"carrer Dagniol"	""	""				
"calle foguerer José Romeu Zarandieta"	"carrer foguerer José Romeu Zarandieta"	""	""				
"calle Santa Leonor"	"carrer Santa Leonor"	""	""				
"calle Santa Felicitas"	"carrer Santa Felicitas"	""	""				
"calle camino de Ronda"	"carrer camino de Ronda"	""	""				
"calle San Juan Bautista"	"carrer San Juan Bautista"	""	""				
"Calle Alférez Rojas"	"Carrer Alférez Rojas"	""	""				
"calle San Salvador"	"carrer San Salvador"	""	""				
"calle catedrático Jaume Mas i Porcel"	"carrer catedrático Jaume Mas i Porcel"	""	""				
"calle Jaime Maria Buch"	"carrer Jaime Maria Buch"	""	""				
"calle poeta Blas de Loma"	"carrer poeta Blas de Loma"	""	""				
"calle Magistral Segura"	"carrer Magistral Segura"	""	""				
"calle Wenceslao Fernández Flóres"	"carrer Wenceslao Fernández Flóres"	""	""				
"calle catedrático Ángel Casado"	"carrer catedrático Ángel Casado"	""	""				
"calle poeta Garcilaso"	"carrer poeta Garcilaso"	""	""				
"calle Presbítero Baltasar Carrasco"	"carrer Presbítero Baltasar Carrasco"	""	""				
"calle Juanito Santero"	"carrer Juanito Santero"	""	""				
"calle marques del Bosch"	"carrer marques del Bosch"	""	""				
"calle Marino Pedro Zaragoza Such"	"carrer Marino Pedro Zaragoza Such"	""	""				
"calle Maestro Bretón"	"carrer Maestro Bretón"	""	""				
"calle foguerer Ramón Gilabert"	"carrer foguerer Ramón Gilabert"	""	""				
"calle pintor Murillo"	"carrer pintor Murillo"	""	""				
"calle Botella de Hornos"	"carrer Botella de Hornos"	""	""				
"calle capitán Amador"	"carrer capitán Amador"	""	""				
"calle capitán Hernández Mira"	"carrer capitán Hernández Mira"	""	""				
"calle capitán Rueda"	"carrer capitán Rueda"	""	""				
"calle Marqués de Molins"	"carrer Marqués de Molins"	""	""				
"calle taquígrafo Martí"	"carrer taquígrafo Martí"	""	""				
"calle Padre Mariana"	"carrer Padre Mariana"	""	""				
"calle teniente Durán"	"carrer teniente Durán"	""	""				
"calle teniente Llorca"	"carrer teniente Llorca"	""	""				
"calle sargento Vaillo"	"carrer sargento Vaillo"	""	""				
"calle maestro Gaztambide"	"carrer maestro Gaztambide"	""	""				
"calle Balmes"	"carrer Balmes"	""	""				
"calle pintor Velázquez"	"carrer pintor Velázquez"	""	""				
"calle teniente Aguado"	"carrer teniente Aguado"	""	""				
"calle sargento del Río"	"carrer sargento del Río"	""	""				
"calle San Leandro"	"carrer San Leandro"	""	""				
"calle Alcalde Alfonso de Rojas"	"carrer Alcalde Alfonso de Rojas"	""	""				
"calle Taquígrafo martí"	"carrer Taquígrafo martí"	""	""				
"calle general Primo de Rivera"	"carrer general Primo de Rivera"	""	""				
"Calle de Labradores"	"Carrer de Labradores"	""	""				
"Calle Montengón"	"Carrer Montengón"	""	""				
"calle maestre Maciá"	"carrer maestre Maciá"	""	""				
"calle Virgen de Belén"	"carrer Virgen de Belén"	""	""				
"calle de abad Najera"	"carrer de abad Najera"	""	""				
"calle de San Nicolás"	"carrer de San Nicolás"	""	""				
"calle Miguel Soler"	"carrer Miguel Soler"	""	""				
"calle padre Maltés"	"carrer padre Maltés"	""	""				
"Calle Padre Sebastian"	"Carrer Padre Sebastian"	""	""				
"Calle Bendicho"	"Carrer Bendicho"	""	""				
"calle Niágara"	"carrer Niágara"	""	""				
"calle ingeniero Farga"	"carrer ingeniero Farga"	""	""				
"calle Gerona"	"carrer Gerona"	""	""				
"calle de los Santos Médicos"	"carrer de los Santos Médicos"	""	""				
"Calle San Antonio"	"Carrer San Antonio"	""	""				
"calle diputado Auset"	"carrer diputado Auset"	""	""				
"Calle San Luis"	"Carrer San Luis"	""	""				
"Calle Dean Zaragoza"	"Carrer Dean Zaragoza"	""	""				
"calle de Barceló"	"carrer de Barceló"	""	""				
"calle de Luzán"	"carrer de Luzán"	""	""				
"Calle Virito"	"Carrer Virito"	""	""				
"calle del Instituto"	"carrer del Instituto"	""	""				
"Calle San Bartolomé"	"Carrer San Bartolomé"	""	""				
"Calle Santa Lucia"	"Carrer Santa Lucia"	""	""				
"calle médico Manero Molla"	"carrer médico Manero Molla"	""	""				
"calle Coloma"	"carrer Coloma"	""	""				
"calle Santa Marta"	"carrer Santa Marta"	""	""				
"calle Cádiz"	"carrer Cádiz"	""	""				
"calle Ribera"	"carrer Ribera"	""	""				
"calle de San Francisco Javier"	"carrer de San Francisco Javier"	""	""				
"calle los Navios"	"carrer los Navios"	""	""				
"calle del Negre Lloma"	"carrer del Negre Lloma"	""	""				
"calle María Josefa Ágreda y Muñoz"	"carrer María Josefa Ágreda y Muñoz"	""	""				
"calle Alberola Romero"	"carrer Alberola Romero"	""	""				
"calle Santo Tomás"	"carrer Santo Tomás"	""	""				
"calle San Andrés"	"carrer San Andrés"	""	""				
"calle de la Verónica"	"carrer de la Verónica"	""	""				
"Calle San Agustín"	"Carrer San Agustín"	""	""				
"calle de Muñoz"	"carrer de Muñoz"	""	""				
"Calle Villavieja"	"Carrer Villavieja"	""	""				
"calle ingeniero Lafarga"	"carrer ingeniero Lafarga"	""	""				
"Calle de Fray Juan Rico"	"Carrer de Fray Juan Rico"	""	""				
"Calle Virgen del Socorro"	"Carrer Virgen del Socorro"	""	""				
"calle San Vicente"	"carrer San Vicente"	""	""				
"calle Marsella"	"carrer Marsella"	""	""				
"calle general Aldave"	"carrer general Aldave"	""	""				
"calle Alcalá Galiano"	"carrer Alcalá Galiano"	""	""				
"calle general Serrano"	"carrer general Serrano"	""	""				
"calle doctor Ferrán"	"carrer doctor Ferrán"	""	""				
"calle Jacinto Maltés"	"carrer Jacinto Maltés"	""	""				
"calle Jazmín"	"carrer Jazmín"	""	""				
"calle Isaac Albeniz"	"carrer Isaac Albeniz"	""	""				
"calle General Elizaicín"	"carrer General Elizaicín"	""	""				
"Calle Ingeniero Canales"	"Carrer Ingeniero Canales"	""	""				
"calle San Ignacio de Loyola"	"carrer San Ignacio de Loyola"	""	""				
"calle doctor Ayela"	"carrer doctor Ayela"	""	""				
"calle Antonio Maura"	"carrer Antonio Maura"	""	""				
"calle doctor Clavero"	"carrer doctor Clavero"	""	""				
"calle alcalde Suárez Llanos"	"carrer alcalde Suárez Llanos"	""	""				
"calle Adolfo Blanch"	"carrer Adolfo Blanch"	""	""				
"calle Hospital del Rey"	"carrer Hospital del Rey"	""	""				
"calle del peligro"	"carrer del peligro"	""	""				
"calle del desengaño"	"carrer del desengaño"	""	""				
"calle los platos"	"carrer los platos"	""	""				
"calle del Empecinado"	"carrer del Empecinado"	""	""				
"Calle Nueva Alta"	"Carrer Nueva Alta"	""	""				
"calle Nueva Baja"	"carrer Nueva Baja"	""	""				
"calle cuesta de la fábrica"	"carrer cuesta de la fábrica"	""	""				
"calle Miguel Crevea"	"carrer Miguel Crevea"	""	""				
"calle Teodoro Llorente"	"carrer Teodoro Llorente"	""	""				
"calle cronista Viravens"	"carrer cronista Viravens"	""	""				
"calle Torres Quevedo"	"carrer Torres Quevedo"	""	""				
"calle Bernardo López García"	"carrer Bernardo López García"	""	""				
"calle García Gutierrez"	"carrer García Gutierrez"	""	""				
"calle del paraiso"	"carrer del paraiso"	""	""				
"Calle San Cayetano"	"Carrer San Cayetano"	""	""				
"Calle Literato Juan Andrés"	"Carrer Literato Juan Andrés"	""	""				
"Calle Doña Violante"	"Carrer Doña Violante"	""	""				
"Calle Canónigo Manuel Penalva"	"Carrer Canónigo Manuel Penalva"	""	""				
"calle plaza doctor Gómez Ulla"	"carrer plaza doctor Gómez Ulla"	""	""				
"Calle Gran Capitán"	"Carrer Gran Capitán"	""	""				
"Calle de la Virgen del Lluch"	"Carrer de la Virgen del Lluch"	""	""				
"calle hermanos López de Osaba"	"carrer hermanos López de Osaba"	""	""				
"Calle Camoens"	"Carrer Camoens"	""	""				
"calle Cerdá"	"carrer Cerdá"	""	""				
"calle Gadea"	"carrer Gadea"	""	""				
"calle aguas de Sax"	"carrer aguas de Sax"	""	""				
"calle Hondón de las Nieves"	"carrer Hondón de las Nieves"	""	""				
"calle Benitachell"	"carrer Benitachell"	""	""				
"calle Ceres"	"carrer Ceres"	""	""				
"calle alcalde España"	"carrer alcalde España"	""	""				
"calle Primitivo Pérez"	"carrer Primitivo Pérez"	""	""				
"calle capitán Quintanilla"	"carrer capitán Quintanilla"	""	""				
"calle general Pintos"	"carrer general Pintos"	""	""				
"calle general Prim"	"carrer general Prim"	""	""				
"calle del fomento"	"carrer del fomento"	""	""				
"calle Rafael Asín"	"carrer Rafael Asín"	""	""				
"calle Javier Carratalá"	"carrer Javier Carratalá"	""	""				
"calle José Serra Lloret"	"carrer José Serra Lloret"	""	""				
"calle Zarandieta"	"carrer Zarandieta"	""	""				
"calle Roselló"	"carrer Roselló"	""	""				
"calle Llinares"	"carrer Llinares"	""	""				
"calle Dámaso Abad"	"carrer Dámaso Abad"	""	""				
"calle ingeniero Sanchís Pujalte"	"carrer ingeniero Sanchís Pujalte"	""	""				
"calle Cerámica"	"carrer Cerámica"	""	""				
"calle Martin Luther King"	"carrer Martin Luther King"	""	""				
"calle Aureliano Ibarra"	"carrer Aureliano Ibarra"	""	""				
"calle Gandhi"	"carrer Gandhi"	""	""				
"calle de Marco Oliver"	"carrer de Marco Oliver"	""	""				
"calle monseñor Romero"	"carrer monseñor Romero"	""	""				
"calle pintor Otilio"	"carrer pintor Otilio"	""	"Calle Pintor Otilio Serrano"				
"calle músico Pau Casals"	"carrer músico Pau Casals"	""	""				
"calle Devesa"	"carrer Devesa"	""	""				
"calle Buenos Aires"	"carrer Buenos Aires"	""	"Gran Vía"				
"calle de Colombia"	"carrer de Colombia"	""	"Gran Vía"				
"calle Olozaga"	"carrer Olozaga"	""	""				
"calle Jaime Segarra"	"carrer Jaime Segarra"	""	""				
"calle Alfonso Guixot"	"carrer Alfonso Guixot"	""	""				
"calle Agustín Gonsalvez Orts"	"carrer Agustín Gonsalvez Orts"	""	""				
"calle Olof Palme"	"carrer Olof Palme"	""	""				
"calle Rovira y Salafranca"	"carrer Rovira y Salafranca"	""	""				
"calle Aaiun"	"carrer Aaiun"	""	""				
"calle Fotógrafa Pilar Cortés Alemañ"	"carrer Fotógrafa Pilar Cortés Alemañ"	""	""				
"calle general Ros de Olano"	"carrer general Ros de Olano"	""	""				
"calle hermanos Soto Chápuli"	"carrer hermanos Soto Chápuli"	""	""				
"calle general Navarro"	"carrer general Navarro"	""	""				
"calle Alcocer de Planes"	"carrer Alcocer de Planes"	""	""				
"calle de Colombia"	"carrer de Colombia"	""	""				
"calle Uruguay"	"carrer Uruguay"	""	""				
"calle San Pedro Poveda"	"carrer San Pedro Poveda"	""	""				
"calle fotógrafa Reme Vélez"	"carrer fotógrafa Reme Vélez"	""	""				
"calle Gran Via"	"carrer Gran Via"	""	""				
"calle de la fuente"	"carrer de la fuente"	""	""				
"calle isla de Cuba"	"carrer isla de Cuba"	""	""				
"calle Virgen de los Lirios"	"carrer Virgen de los Lirios"	""	""				
"calle Unicef"	"carrer Unicef"	""	""				
"calle de Alcoleja"	"carrer de Alcoleja"	""	""				
"calle Agustín Jiménez Navarlaz"	"carrer Agustín Jiménez Navarlaz"	""	""				
"calle poeta Sansano"	"carrer poeta Sansano"	""	""				
"calle Pedro Mas García"	"carrer Pedro Mas García"	""	""				
"calle Pardo Bazán"	"carrer Pardo Bazán"	""	""				
"calle de la prosperidad"	"carrer de la prosperidad"	""	""				
"calle Francisco Montero Pérez"	"carrer Francisco Montero Pérez"	""	""				
"calle Juan de Juanes"	"carrer Juan de Juanes"	""	""				
"calle Ciudad de Alfaro"	"carrer Ciudad de Alfaro"	""	""				
"calle Escoto"	"carrer Escoto"	""	""				
"calle Linares"	"carrer Linares"	""	""				
"Calle Prosperidad"	"Carrer Prosperidad"	""	""				
"calle José Reus García"	"carrer José Reus García"	""	""				
"calle Prosperidad"	"carrer Prosperidad"	""	""				
"calle Manuel Maciá"	"carrer Manuel Maciá"	""	""				
"calle Ciudad de Bari"	"carrer Ciudad de Bari"	""	""				
"calle Daya Vieja"	"carrer Daya Vieja"	""	""				
"calle Daya Nueva"	"carrer Daya Nueva"	""	""				
"calle de Tibi"	"carrer de Tibi"	""	""				
"calle sacerdote Isidro Albert"	"carrer sacerdote Isidro Albert"	""	"Gran Vía"				
"calle Antonio de Trueba"	"carrer Antonio de Trueba"	""	""				
"calle Garbinet"	"carrer Garbinet"	""	""				
"calle Julio Antonio"	"carrer Julio Antonio"	""	""				
"calle poeta Zorrilla"	"carrer poeta Zorrilla"	""	""				
"calle Dato Iradier"	"carrer Dato Iradier"	""	""				
"calle Pascual Mata"	"carrer Pascual Mata"	""	""				
"calle doctor Esquerdo"	"carrer doctor Esquerdo"	""	""				
"calle Francisco Verdú"	"carrer Francisco Verdú"	""	""				
"calle maestro Alonso"	"carrer maestro Alonso"	""	""				
"calle Martos"	"carrer Martos"	""	""				
"calle catedrático Daniel Jiménez"	"carrer catedrático Daniel Jiménez"	""	""				
"calle del 9 d'octubre"	"carrer del 9 d'octubre"	""	""				
"calle Francisco González Sánchez"	"carrer Francisco González Sánchez"	""	""				
"calle San Mateo"	"carrer San Mateo"	""	""				
"calle pintor Zuloaga"	"carrer pintor Zuloaga"	""	""				
"calle Fiscal Miguel Gutiérrez Carbonell"	"carrer Fiscal Miguel Gutiérrez Carbonell"	""	""				
"calle Felipe Herrero"	"carrer Felipe Herrero"	""	""				
"calle Béjar"	"carrer Béjar"	""	""				
"calle San Benito"	"carrer San Benito"	""	""				
"calle Fidel Pastor"	"carrer Fidel Pastor"	""	""				
"calle Miguel Jiménez Reyes"	"carrer Miguel Jiménez Reyes"	""	""				
"calle Enrique Pérez Cascales"	"carrer Enrique Pérez Cascales"	""	""				
"calle río Serpis"	"carrer río Serpis"	""	""				
"calle río Amadorio"	"carrer río Amadorio"	""	""				
"calle ingeniero Canales"	"carrer ingeniero Canales"	""	""				
"calle Heroldo Parrés"	"carrer Heroldo Parrés"	""	""				
"calle Gimnasta Maisa Lloret"	"carrer Gimnasta Maisa Lloret"	""	""				
"calle Gonzalo Mengual"	"carrer Gonzalo Mengual"	""	""				
"calle Inmaculada del Plá"	"carrer Inmaculada del Plá"	""	""				
"calle río Seco"	"carrer río Seco"	""	""				
"calle doctor Sánchez San Julián"	"carrer doctor Sánchez San Julián"	""	""				
"calle hermanos Medina"	"carrer hermanos Medina"	""	""				
"calle Sénija"	"carrer Sénija"	""	""				
"calle Sagra"	"carrer Sagra"	""	""				
"calle plaza de la Estrella"	"carrer plaza de la Estrella"	""	""				
"calle periodista Rodolfo Salazar"	"carrer periodista Rodolfo Salazar"	""	""				
"calle Josep Lluis Albinyana i Olmos"	"carrer Josep Lluis Albinyana i Olmos"	""	""				
"calle Enrique Monsonís Domingo"	"carrer Enrique Monsonís Domingo"	""	""				
"calle médico Vicente Reyes"	"carrer médico Vicente Reyes"	""	""				
"calle José Llopis Díaz"	"carrer José Llopis Díaz"	""	""				
"calle biólogo Konrad Lorenz"	"carrer biólogo Konrad Lorenz"	""	""				
"calle doctor Carlos Belmonte"	"carrer doctor Carlos Belmonte"	""	""				
"calle bailarín José Espadero"	"carrer bailarín José Espadero"	""	""				
"calle doctor Juan Ferrer"	"carrer doctor Juan Ferrer"	""	""				
"calle doctor Federico Manero"	"carrer doctor Federico Manero"	""	""				
"calle doctor Rafael Martínez Sanpedro"	"carrer doctor Rafael Martínez Sanpedro"	""	""				
"calle doctor Angel Tello Ortiz"	"carrer doctor Angel Tello Ortiz"	""	""				
"calle Pradilla"	"carrer Pradilla"	""	""				
"calle doctor Bérgez"	"carrer doctor Bérgez"	""	""				
"calle Foguerer"	"carrer Foguerer"	""	""				
"calle San Pablo"	"carrer San Pablo"	""	""				
"calle doctor Nieto"	"carrer doctor Nieto"	""	""				
"calle Gasset y Artime"	"carrer Gasset y Artime"	""	""				
"calle Plus Ultra"	"carrer Plus Ultra"	""	""				
"calle Montero Ríos"	"carrer Montero Ríos"	""	""				
"calle Pantaleón Boné"	"carrer Pantaleón Boné"	""	""				
"calle San Miguel de Salinas"	"carrer San Miguel de Salinas"	""	""				
"calle Granja de Rocamora"	"carrer Granja de Rocamora"	""	""				
"calle Benifallim"	"carrer Benifallim"	""	""				
"calle general Polavieja"	"carrer general Polavieja"	""	""				
"calle Rafael Ruiz Cuesta"	"carrer Rafael Ruiz Cuesta"	""	""				
"calle Doctor José Luis de la Vega"	"carrer Doctor José Luis de la Vega"	""	""				
"calle Juan de Garay"	"carrer Juan de Garay"	""	""				
"calle Sidi Ifni"	"carrer Sidi Ifni"	""	"Gran Vía"				
"calle Famorca"	"carrer Famorca"	""	""				
"calle Francisco Giner de los Rios"	"carrer Francisco Giner de los Rios"	""	""				
"calle Marta Barrie"	"carrer Marta Barrie"	""	""				
"calle Rodrigo Caro"	"carrer Rodrigo Caro"	""	""				
"calle benefactora Remedios Uriarte"	"carrer benefactora Remedios Uriarte"	""	""				
"calle Vall de Alcalá"	"carrer Vall de Alcalá"	""	""				
"calle Antonio Noguera"	"carrer Antonio Noguera"	""	""				
"calle de la Jacaranda"	"carrer de la Jacaranda"	""	""				
"calle San Fulgencio"	"carrer San Fulgencio"	""	""				
"calle Tollos"	"carrer Tollos"	""	""				
"calle Gayanes"	"carrer Gayanes"	""	""				
"calle Alcolecha"	"carrer Alcolecha"	""	""				
"calle Benimasot"	"carrer Benimasot"	""	""				
"calle Formentera del Segura"	"carrer Formentera del Segura"	""	""				
"calle Facheca"	"carrer Facheca"	""	""				
"calle de la Alcolecha"	"carrer de la Alcolecha"	""	""				
"calle Millena"	"carrer Millena"	""	""				
"calle Gorga"	"carrer Gorga"	""	""				
"calle Lorcha"	"carrer Lorcha"	""	""				
"calle Alquería de Aznar"	"carrer Alquería de Aznar"	""	""				
"calle Beniarrés"	"carrer Beniarrés"	""	""				
"calle Balones"	"carrer Balones"	""	""				
"calle doctor Juan López Sánchez"	"carrer doctor Juan López Sánchez"	""	""				
"calle doctor Cristobal Pardo"	"carrer doctor Cristobal Pardo"	""	""				
"calle Rafael García Vidal"	"carrer Rafael García Vidal"	""	""				
"calle Ercilla"	"carrer Ercilla"	""	""				
"Calle Médico García Álvarez"	"Carrer Médico García Álvarez"	""	""				
"calle doctor José Belmonte"	"carrer doctor José Belmonte"	""	""				
"calle doctor Carlos Mazón"	"carrer doctor Carlos Mazón"	""	""				
"calle doctor Ángel Pascual Megías"	"carrer doctor Ángel Pascual Megías"	""	""				
"calle hermanos doctores Server Cerdá"	"carrer hermanos doctores Server Cerdá"	""	""				
"calle Gata de Gorgos"	"carrer Gata de Gorgos"	""	""				
"calle Aguas Vivas"	"carrer Aguas Vivas"	""	""				
"calle beato Diego de Cádiz"	"carrer beato Diego de Cádiz"	""	""				
"calle monte Albernia"	"carrer monte Albernia"	""	""				
"calle Virgen de la Luz"	"carrer Virgen de la Luz"	""	""				
"calle Avellaneda"	"carrer Avellaneda"	""	""				
"calle Luis Amigo"	"carrer Luis Amigo"	""	""				
"Calle Padre Francisco"	"Carrer Padre Francisco"	""	""				
"calle padre Francisco"	"carrer padre Francisco"	""	""				
"calle de la ovejita"	"carrer de la ovejita"	""	""				
"calle del Lobo de Gubio"	"carrer del Lobo de Gubio"	""	""				
"calle pintor Rosales"	"carrer pintor Rosales"	""	""				
"calle pintor Van Dick"	"carrer pintor Van Dick"	""	""				
"Calle Isidoro Sevilla"	"Carrer Isidoro Sevilla"	""	""				
"calle Virgen de Loreto"	"carrer Virgen de Loreto"	""	""				
"calle Miguel Bernal"	"carrer Miguel Bernal"	""	""				
"calle Bolulla"	"carrer Bolulla"	""	""				
"calle Benidoleig"	"carrer Benidoleig"	""	""				
"calle pintor Miguel Angel"	"carrer pintor Miguel Angel"	""	""				
"calle Valdés Leal"	"carrer Valdés Leal"	""	""				
"calle de Alicante"	"carrer de Alicante"	""	""				
"calle de Trento"	"carrer de Trento"	""	""				
"calle Rubens"	"carrer Rubens"	""	""				
"calle del Aeroplano"	"carrer del Aeroplano"	""	""				
"calle Villafranqueza"	"carrer Villafranqueza"	""	""				
"calle La Esperanza"	"carrer La Esperanza"	""	""				
"calle Lo Torrent"	"carrer Lo Torrent"	""	""				
"calle Bronce"	"carrer Bronce"	""	""				
"calle del Zinc"	"carrer del Zinc"	""	""				
"calle Finca el Pilar"	"carrer Finca el Pilar"	""	""				
"calle Aviación"	"carrer Aviación"	""	""				
"calle de Vicente Savall"	"carrer de Vicente Savall"	""	""				
"Calle Bautista Aznar"	"Carrer Bautista Aznar"	""	""				
"calle Vulcano"	"carrer Vulcano"	""	""				
"calle García Lorca"	"carrer García Lorca"	""	""				
"calle Vicente Savall Pascual"	"carrer Vicente Savall Pascual"	""	""				
"Calle Ángela Lloret"	"Carrer Ángela Lloret"	""	""				
"calle Ciudad Jardín"	"carrer Ciudad Jardín"	""	""				
"calle Decano"	"carrer Decano"	""	""				
"calle Rector"	"carrer Rector"	""	""				
"calle Bedel"	"carrer Bedel"	""	""				
"calle Aeródromo"	"carrer Aeródromo"	""	""				
"calle de la Margarita"	"carrer de la Margarita"	""	""				
"calle de los Rosales"	"carrer de los Rosales"	""	""				
"calle Cottolengo"	"carrer Cottolengo"	""	""				
"calle Estaño"	"carrer Estaño"	""	""				
"calle Sagrat"	"carrer Sagrat"	""	""				
"calle Magnolias"	"carrer Magnolias"	""	""				
"calle de los Lirios"	"carrer de los Lirios"	""	""				
"calle de los Geranios"	"carrer de los Geranios"	""	""				
"calle de los Nenúfares"	"carrer de los Nenúfares"	""	""				
"calle de la Cerámica"	"carrer de la Cerámica"	""	""				
"calle Juncaret"	"carrer Juncaret"	""	""				
"calle Sella"	"carrer Sella"	""	""				
"calle Rayo"	"carrer Rayo"	""	""				
"calle la Plata"	"carrer la Plata"	""	""				
"calle Duero"	"carrer Duero"	""	""				
"calle de los Jazmines"	"carrer de los Jazmines"	""	""				
"calle pintor Rodes"	"carrer pintor Rodes"	""	""				
"calle Diputada Pilar Bravo Castells"	"carrer Diputada Pilar Bravo Castells"	""	""				
"calle Lugo"	"carrer Lugo"	""	""				
"calle Dámaso Alonso"	"carrer Dámaso Alonso"	""	""				
"calle Cartegena"	"carrer Cartegena"	""	""				
"calle Pascual Bone"	"carrer Pascual Bone"	""	""				
"calle Villa de Chiva"	"carrer Villa de Chiva"	""	""				
"calle canónigo Giner"	"carrer canónigo Giner"	""	""				
"calle sierra de Aitana"	"carrer sierra de Aitana"	""	""				
"calle serra Cabeç d'Or"	"carrer serra Cabeç d'Or"	""	""				
"calle Sierra del Montgó"	"carrer Sierra del Montgó"	""	""				
"calle Cuarzo"	"carrer Cuarzo"	""	""				
"calle serra Mariola"	"carrer serra Mariola"	""	""				
"calle Sierra de Bernia"	"carrer Sierra de Bernia"	""	""				
"calle presbítero Gisbert"	"carrer presbítero Gisbert"	""	""				
"calle Poeta Gerardo Diego"	"carrer Poeta Gerardo Diego"	""	""				
"calle Poeta Leopoldo Panero"	"carrer Poeta Leopoldo Panero"	""	""				
"calle Turquesa"	"carrer Turquesa"	""	""				
"calle Diputado Juan Antonio Rodríguez Marín"	"carrer Diputado Juan Antonio Rodríguez Marín"	""	""				
"calle Senador Alberto Javier Pérez Ferré"	"carrer Senador Alberto Javier Pérez Ferré"	""	""				
"calle Senador Vicente Bevia Pastor"	"carrer Senador Vicente Bevia Pastor"	""	""				
"calle Senador Roque Calpena Giménez"	"carrer Senador Roque Calpena Giménez"	""	""				
"calle Abad Fernández Heguera"	"carrer Abad Fernández Heguera"	""	""				
"calle del Ópalo"	"carrer del Ópalo"	""	""				
"calle escritor Fernández Torremocha"	"carrer escritor Fernández Torremocha"	""	""				
"Calle Bananero"	"Carrer Bananero"	""	""				
"Calle Abedul"	"Carrer Abedul"	""	""				
"Calle Platanero"	"Carrer Platanero"	""	""				
"Calle Abeto"	"Carrer Abeto"	""	""				
"Calle Tomateras"	"Carrer Tomateras"	""	""				
"calle cronista Vicente Martínez Morella"	"carrer cronista Vicente Martínez Morella"	""	""				
"calle Alonoso Cano"	"carrer Alonoso Cano"	""	""				
"calle Benisa"	"carrer Benisa"	""	""				
"calle Redován"	"carrer Redován"	""	""				
"calle Benejúzar"	"carrer Benejúzar"	""	""				
"calle diputado Luís Jiménez Morell"	"carrer diputado Luís Jiménez Morell"	""	""				
"calle Muro de Alcoy"	"carrer Muro de Alcoy"	""	""				
"calle Sierra de Caballs"	"carrer Sierra de Caballs"	""	""				
"calle Senador José Vicente Mateo"	"carrer Senador José Vicente Mateo"	""	""				
"calle diputado Joaquín Fuster"	"carrer diputado Joaquín Fuster"	""	""				
"calle sierra de Pandols"	"carrer sierra de Pandols"	""	""				
"calle Benissa"	"carrer Benissa"	""	""				
"calle Antonio Ramos Carratalá"	"carrer Antonio Ramos Carratalá"	""	""				
"calle Poeta Balart"	"carrer Poeta Balart"	""	""				
"calle Els Poblets"	"carrer Els Poblets"	""	""				
"calle Miradores"	"carrer Miradores"	""	""				
"calle pintor Astorza"	"carrer pintor Astorza"	""	""				
"calle pintor Pedro Camacho"	"carrer pintor Pedro Camacho"	""	""				
"calle Los Montesinos"	"carrer Los Montesinos"	""	""				
"calle pintor Antonio Amorós"	"carrer pintor Antonio Amorós"	""	""				
"calle san Juan de la Cruz"	"carrer san Juan de la Cruz"	""	""				
"calle Salvador Allende"	"carrer Salvador Allende"	""	""				
"calle barítono Paco Latorre"	"carrer barítono Paco Latorre"	""	""				
"calle del Marqués de Santillana"	"carrer del Marqués de Santillana"	""	""				
"calle de Juan Ramón Jiménez"	"carrer de Juan Ramón Jiménez"	""	""				
"Calle Mármol"	"Carrer Mármol"	""	""				
"Calle Alfarería"	"Carrer Alfarería"	""	""				
"Calle Porcelana"	"Carrer Porcelana"	""	""				
"Calle Médico Francisco Boix"	"Carrer Médico Francisco Boix"	""	""				
"Calle San Vicente del Raspeig"	"Carrer San Vicente del Raspeig"	""	""				
"calle de las Parras"	"carrer de las Parras"	""	""				
"calle Balsa del Ebro"	"carrer Balsa del Ebro"	""	""				
"calle Vicente Lillo Cánovas"	"carrer Vicente Lillo Cánovas"	""	""				
"calle del Charques y Esplá"	"carrer del Charques y Esplá"	""	""				
"calle Luis Alberola Ferrándiz"	"carrer Luis Alberola Ferrándiz"	""	""				
"calle Cura Miguel Bernabeu Amat"	"carrer Cura Miguel Bernabeu Amat"	""	""				
"calle de la Bolsa Negra"	"carrer de la Bolsa Negra"	""	""				
"calle del Barranco del Palamó"	"carrer del Barranco del Palamó"	""	""				
"Calle Sociedad Cultural Deportiva Villafranqueza"	"Carrer Sociedad Cultural Deportiva Villafranqueza"	""	""				
"Calle Fray Francisco Guijarro"	"Carrer Fray Francisco Guijarro"	""	""				
"calle Unión Musical La Amistad"	"carrer Unión Musical La Amistad"	""	""				
"calle del Músico Carlos Cosmen"	"carrer del Músico Carlos Cosmen"	""	""				
"calle Notario Blatasar Vidaña"	"carrer Notario Blatasar Vidaña"	""	""				
"calle Músico Antonio Guijarro Ripoll"	"carrer Músico Antonio Guijarro Ripoll"	""	""				
"calle Practicante Vicente Blasco"	"carrer Practicante Vicente Blasco"	""	""				
"Calle Conde Pedro Franqueza"	"Carrer Conde Pedro Franqueza"	""	""				
"Calle Obispo Vitorio Oliver Domingo"	"Carrer Obispo Vitorio Oliver Domingo"	""	""				
"calle Virgen de la Paloma"	"carrer Virgen de la Paloma"	""	""				
"calle del Padre Faustino Miguez"	"carrer del Padre Faustino Miguez"	""	""				
"calle Salvador García Muñoz"	"carrer Salvador García Muñoz"	""	""				
"calle Virgen de las injurias"	"carrer Virgen de las injurias"	""	""				
"calle San Julián"	"carrer San Julián"	""	""				
"calle del Algar"	"carrer del Algar"	""	""				
"calle doña Dolsa"	"carrer doña Dolsa"	""	""				
"calle escritor Gonzalo Canto"	"carrer escritor Gonzalo Canto"	""	""				
"calle de la Virgen de Gracia"	"carrer de la Virgen de Gracia"	""	""				
"calle del Padre Arrupe"	"carrer del Padre Arrupe"	""	""				
"calle camino de la Cruz de Piedra"	"carrer camino de la Cruz de Piedra"	""	""				
"calle madre Teresa de Calcuta"	"carrer madre Teresa de Calcuta"	""	""				
"calle José Barreres Pérez"	"carrer José Barreres Pérez"	""	""				
"calle doctor José Babe Delgado"	"carrer doctor José Babe Delgado"	""	""				
"calle artista del fuego Ramón Marco"	"carrer artista del fuego Ramón Marco"	""	""				
"calle de los hermanos Álvarez Quintero"	"carrer de los hermanos Álvarez Quintero"	""	""				
"calle Jardiel Poncela"	"carrer Jardiel Poncela"	""	""				
"calle Santiago Rusiñol"	"carrer Santiago Rusiñol"	""	""				
"calle médico Angel Pascual Devesa"	"carrer médico Angel Pascual Devesa"	""	""				
"calle Albert Einstein"	"carrer Albert Einstein"	""	""				
"calle Bellea del foc"	"carrer Bellea del foc"	""	""				
"calle Gabriel y Galán"	"carrer Gabriel y Galán"	""	""				
"calle Granja"	"carrer Granja"	""	""				
"calle Jurista López Amo"	"carrer Jurista López Amo"	""	""				
"calle de Jacinto Masanet"	"carrer de Jacinto Masanet"	""	""				
"calle Muñoz Seca"	"carrer Muñoz Seca"	""	""				
"calle deportista Navarro Olcina"	"carrer deportista Navarro Olcina"	""	""				
"calle de la Cruz de Piedra"	"carrer de la Cruz de Piedra"	""	""				
"calle Escultor Adrián Carrillo"	"carrer Escultor Adrián Carrillo"	""	""				
"Calle Sol Naciente"	"Carrer Sol Naciente"	""	""				
"calle Sierra de Gredos"	"carrer Sierra de Gredos"	""	""				
"calle Poeta Requena"	"carrer Poeta Requena"	""	""				
"calle poeta Bécquer"	"carrer poeta Bécquer"	""	""				
"calle Periodista Adrián López"	"carrer Periodista Adrián López"	""	""				
"calle Antulio San Juan"	"carrer Antulio San Juan"	""	""				
"calle José Aldeguer"	"carrer José Aldeguer"	""	""				
"calle monte San Julián"	"carrer monte San Julián"	""	""				
"calle Bassetes"	"carrer Bassetes"	""	""				
"calle del Galeón"	"carrer del Galeón"	""	""				
"Calle Velero"	"Carrer Velero"	""	""				
"calle Catamarán"	"carrer Catamarán"	""	""				
"Calle Anzuelo"	"Carrer Anzuelo"	""	""				
"calle del Balandre"	"carrer del Balandre"	""	""				
"calle periodista Asunción Valdés"	"carrer periodista Asunción Valdés"	""	""				
"Calle Redes"	"Carrer Redes"	""	""				
"calle científico Jaime Santana"	"carrer científico Jaime Santana"	""	""				
"calle Pedro Ferrándiz"	"carrer Pedro Ferrándiz"	""	""				
"calle del Chopo"	"carrer del Chopo"	""	""				
"calle del eucalipto"	"carrer del eucalipto"	""	""				
"calle del sauce"	"carrer del sauce"	""	""				
"calle del roble"	"carrer del roble"	""	""				
"calle Orgegia"	"carrer Orgegia"	""	""				
"calle del manzano"	"carrer del manzano"	""	""				
"calle del peral"	"carrer del peral"	""	""				
"calle de Vistahermosa"	"carrer de Vistahermosa"	""	""				
"Calle de la encina"	"Carrer de la encina"	""	""				
"Calle del fresno"	"Carrer del fresno"	""	""				
"calle pitera"	"carrer pitera"	""	""				
"calle de la Alondra"	"carrer de la Alondra"	""	""				
"Calle del sauce"	"Carrer del sauce"	""	""				
"calle del castaño"	"carrer del castaño"	""	""				
"calle Numancia"	"carrer Numancia"	""	""				
"Calle Ovidio"	"Carrer Ovidio"	""	""				
"calle del Vencejo"	"carrer del Vencejo"	""	""				
"calle de la Golondrina"	"carrer de la Golondrina"	""	""				
"calle del Jilguero"	"carrer del Jilguero"	""	""				
"calle de la Mostaza"	"carrer de la Mostaza"	""	""				
"calle del Sándalo"	"carrer del Sándalo"	""	""				
"calle de la Ruda"	"carrer de la Ruda"	""	""				
"calle del Hogar Provincial"	"carrer del Hogar Provincial"	""	""				
"calle del Azahar"	"carrer del Azahar"	""	""				
"calle del Romero"	"carrer del Romero"	""	""				
"calle del Cantueso"	"carrer del Cantueso"	""	""				
"calle del Hinojo"	"carrer del Hinojo"	""	""				
"calle de la Alávega"	"carrer de la Alávega"	""	""				
"Calle Hierbabuena"	"Carrer Hierbabuena"	""	""				
"Calle Enebro"	"Carrer Enebro"	""	""				
"Calle Espliego"	"Carrer Espliego"	""	""				
"Calle Loma Hermosa"	"Carrer Loma Hermosa"	""	""				
"Calle Orégano"	"Carrer Orégano"	""	""				
"calle edil Marina Olcina"	"carrer edil Marina Olcina"	""	""				
"calle Joan Nomdedéu"	"carrer Joan Nomdedéu"	""	""				
"Calle El de Pagán"	"Carrer El de Pagán"	"Carrer Alcalde Juan Gosalvez"	"Calle Alcalde Juan Gosalvez"				
"calle de Benimagrell"	"carrer de Benimagrell"	""	""				
"calle Alberola Canterac"	"carrer Alberola Canterac"	""	""				
"calle del Alcalde José Abad"	"carrer del Alcalde José Abad"	""	""				
"calle Vicente Rocamora Onteniente"	"carrer Vicente Rocamora Onteniente"	""	""				
"calle Mayor de la Santa Faz"	"carrer Mayor de la Santa Faz"	""	""				
"calle de San Diego"	"carrer de San Diego"	""	""				
"calle Alberola Canteral"	"carrer Alberola Canteral"	""	""				
"calle Juana Francés"	"carrer Juana Francés"	""	""				
"calle Edil Marina Olcina"	"carrer Edil Marina Olcina"	""	""				
"calle Historiador Rafael Altamira"	"carrer Historiador Rafael Altamira"	""	""				
"calle del Teuladí"	"carrer del Teuladí"	""	""				
"Calle Brazal de San Roque"	"Carrer Brazal de San Roque"	""	""				
"Calle el de Pagán"	"Carrer el de Pagán"	""	""				
"calle maestra Filomena Fernández"	"carrer maestra Filomena Fernández"	""	""				
"calle Vistalmar"	"carrer Vistalmar"	""	""				
"calle Palau"	"carrer Palau"	""	""				
"calle del Vino"	"carrer del Vino"	""	""				
"calle del Gato"	"carrer del Gato"	""	""				
"calle del Ruiseñor"	"carrer del Ruiseñor"	""	""				
"calle de la Costa Azul"	"carrer de la Costa Azul"	""	""				
"calle de la Costa Daurada"	"carrer de la Costa Daurada"	""	""				
"calle Pedagoga Amelia Asensi Beviá"	"carrer Pedagoga Amelia Asensi Beviá"	""	""				
"calle de la Costa Blanca"	"carrer de la Costa Blanca"	""	""				
"calle del Ciervo"	"carrer del Ciervo"	""	""				
"calle de la Gaviota"	"carrer de la Gaviota"	""	""				
"Calle Comadrona Teresa Pedro Ferrándiz"	"Carrer Comadrona Teresa Pedro Ferrándiz"	""	""				
"calle Comadrona Josefa Gomis Aracil"	"carrer Comadrona Josefa Gomis Aracil"	""	""				
"calle Rector Ramón Martín Mateo"	"carrer Rector Ramón Martín Mateo"	""	""				
"calle Rector Jesús Rodríguez Marín"	"carrer Rector Jesús Rodríguez Marín"	""	""				
"calle Comadrona Teresa Sarrió Busquier"	"carrer Comadrona Teresa Sarrió Busquier"	""	""				
"calle de Busot"	"carrer de Busot"	""	""				
"calle de Altea"	"carrer de Altea"	""	""				
"calle Benefactora Josefina Campos Fernández"	"carrer Benefactora Josefina Campos Fernández"	""	""				
"calle Pablo Puerto Calpena"	"carrer Pablo Puerto Calpena"	""	""				
"calle de Granada"	"carrer de Granada"	""	""				
"calle Virgen de los Remedios"	"carrer Virgen de los Remedios"	""	""				
"calle del Turó"	"carrer del Turó"	""	""				
"calle del Tigre"	"carrer del Tigre"	""	""				
"calle de los Lobos"	"carrer de los Lobos"	""	""				
"calle de la Pantera"	"carrer de la Pantera"	""	""				
"calle del Moralet"	"carrer del Moralet"	""	""				
"calle de la Cañada"	"carrer de la Cañada"	""	""				
"calle del Verdegás"	"carrer del Verdegás"	""	""				
"calle Felipe González"	"carrer Felipe González"	""	""				
"calle Las Lomas"	"carrer Las Lomas"	""	""				
"calle Tierno Galvañ"	"carrer Tierno Galvañ"	""	""				
"calle Rey Juan Carlos I"	"carrer Rey Juan Carlos I"	""	""				
"calle de la Alcoraya"	"carrer de la Alcoraya"	""	""				
"calle del Lince"	"carrer del Lince"	""	""				
"calle del Zorro"	"carrer del Zorro"	""	""				
"calle del Oso"	"carrer del Oso"	""	""				
"calle del Chacal"	"carrer del Chacal"	""	""				
"calle Cabo de Gata"	"carrer Cabo de Gata"	""	""				
"calle Cabo de San Antonio"	"carrer Cabo de San Antonio"	""	""				
"calle del Odiel"	"carrer del Odiel"	""	""				
"calle Cabo San Adrián"	"carrer Cabo San Adrián"	""	""				
"calle del Cabo Lage"	"carrer del Cabo Lage"	""	""				
"calle del Cabo Tortosa"	"carrer del Cabo Tortosa"	""	""				
"calle del Desierto-Pintat"	"carrer del Desierto-Pintat"	""	""				
"calle Mayor-Verdegás"	"carrer Mayor-Verdegás"	""	""				
"calle de la Merced"	"carrer de la Merced"	""	""				
"calle de la Convivencia"	"carrer de la Convivencia"	""	""				
"calle Doctora Blasco Marhuenda"	"carrer Doctora Blasco Marhuenda"	""	""				
"calle Chinorlet"	"carrer Chinorlet"	""	""				
"calle del Oasis"	"carrer del Oasis"	""	""				
"calle Oasis-Pintat"	"carrer Oasis-Pintat"	""	""				
"calle Mármol - Garroferal"	"carrer Mármol - Garroferal"	""	""				
"calle Mar Negro - Ermita del Moralet"	"carrer Mar Negro - Ermita del Moralet"	""	""				
"calle Circón - Garroferal"	"carrer Circón - Garroferal"	""	""				
"calle Amianto - Garroferal"	"carrer Amianto - Garroferal"	""	""				
"calle Blenda - Garroferal"	"carrer Blenda - Garroferal"	""	""				
"calle Cobre - Garroferal"	"carrer Cobre - Garroferal"	""	""				
"calle Mar Caspio - Ermita del Moralet"	"carrer Mar Caspio - Ermita del Moralet"	""	""				
"calle Estaño - Garroferal"	"carrer Estaño - Garroferal"	""	""				
"calle Selenio - Garroferal"	"carrer Selenio - Garroferal"	""	""				
"calle del Níscalo"	"carrer del Níscalo"	""	""				
"calle Calatrava"	"carrer Calatrava"	""	""				
"calle Daimiel"	"carrer Daimiel"	""	""				
"calle del Cartón"	"carrer del Cartón"	""	""				
"calle del Martillo"	"carrer del Martillo"	""	""				
"calle del Clavo"	"carrer del Clavo"	""	""				
"calle de la Fragua"	"carrer de la Fragua"	""	""				
"calle del Turrón"	"carrer del Turrón"	""	""				
"calle Caucho"	"carrer Caucho"	""	""				
"calle del Cincel"	"carrer del Cincel"	""	""				
"calle Artesanos"	"carrer Artesanos"	""	""				
"calle Herrerías"	"carrer Herrerías"	""	""				
"calle del Torno"	"carrer del Torno"	""	""				
"calle Daoiz y Velarde"	"carrer Daoiz y Velarde"	""	""				
"calle Las Cañas"	"carrer Las Cañas"	""	""				
"calle Los Juncos"	"carrer Los Juncos"	""	""				
"calle Los Mimbres"	"carrer Los Mimbres"	""	""				
"calle Ausías March"	"carrer Ausías March"	""	""				
"calle Pérez Galdós"	"carrer Pérez Galdós"	""	""				
"calle Presbítero Aracil"	"carrer Presbítero Aracil"	""	""				
"calle Álvarez Quintero"	"carrer Álvarez Quintero"	""	""				
"calle Menéndez Pidal"	"carrer Menéndez Pidal"	""	""				
"calle Dr. Alós"	"carrer Dr. Alós"	""	""				
"calle Lillo Juan"	"carrer Lillo Juan"	""	""				
"calle Las Navas"	"carrer Las Navas"	""	""				
"calle San Antonio"	"carrer San Antonio"	""	""				
"calle San Carlos"	"carrer San Carlos"	""	""				
"calle Castella"	"carrer Castella"	""	""				
"calle Rafael Sabater Llopis"	"carrer Rafael Sabater Llopis"	""	""				
"calle Dénia"	"carrer Dénia"	""	""				
"calle Manuel Domínguez"	"carrer Manuel Domínguez"	""	""				
"calle de Pío Baroja"	"carrer de Pío Baroja"	""	""				
"calle Trinquet - camí de la Casa Groga"	"carrer Trinquet - camí de la Casa Groga"	""	""				
"calle Canastell"	"carrer Canastell"	""	""				
"calle Atoxa"	"carrer Atoxa"	""	""				
"calle del Yunque"	"carrer del Yunque"	""	""				
"calle San Bernardo"	"carrer San Bernardo"	""	""				
"calle Illes Baleares"	"carrer Illes Baleares"	""	""				
"calle Almazara"	"carrer Almazara"	""	""				
"calle Monforte"	"carrer Monforte"	""	""				
"calle Músico Mariano Pérez"	"carrer Músico Mariano Pérez"	""	""				
"calle Río Bravo - Finca Don Jaime"	"carrer Río Bravo - Finca Don Jaime"	""	""				
"calle Basalto - Garroferal"	"carrer Basalto - Garroferal"	""	""				
"calle Río Garona - Finca Don Jaime"	"carrer Río Garona - Finca Don Jaime"	""	""				
"calle Granito - Garroferal"	"carrer Granito - Garroferal"	""	""				
"calle Río Mississipi - Finca Don Jaime"	"carrer Río Mississipi - Finca Don Jaime"	""	""				
"calle Río Nilo - Finca Don Jaime"	"carrer Río Nilo - Finca Don Jaime"	""	""				
"calle Río Volga - Finca Don Jaime"	"carrer Río Volga - Finca Don Jaime"	""	""				
"calle Río Danubio - Finca Don Jaime"	"carrer Río Danubio - Finca Don Jaime"	""	""				
"calle Río Loira - Finca Don Jaime"	"carrer Río Loira - Finca Don Jaime"	""	""				
"calle Bauxita - Garroferal"	"carrer Bauxita - Garroferal"	""	""				
"calle del Reno"	"carrer del Reno"	""	""				
"calle Paralela de la Fragata"	"carrer Paralela de la Fragata"	""	""				
"calle de la Jirafa"	"carrer de la Jirafa"	""	""				
"calle de la Gacela"	"carrer de la Gacela"	""	""				
"calle Río Tamesis - Finca Don Jaime"	"carrer Río Tamesis - Finca Don Jaime"	""	""				
"calle del Bambi"	"carrer del Bambi"	""	""				
"calle de la Llama"	"carrer de la Llama"	""	""				
"calle del Muflón"	"carrer del Muflón"	""	""				
"calle del Corzo"	"carrer del Corzo"	""	""				
"calle Paralela Aves Acuáticas"	"carrer Paralela Aves Acuáticas"	""	""				
"calle de la Oca"	"carrer de la Oca"	""	""				
"calle la trucha"	"carrer la trucha"	""	""				
"calle de las Aves Acuáticas"	"carrer de las Aves Acuáticas"	""	""				
"calle de la Fragata"	"carrer de la Fragata"	""	""				
"calle de la Grulla"	"carrer de la Grulla"	""	""				
"calle del Pelícano"	"carrer del Pelícano"	""	""				
"calle de la Garza"	"carrer de la Garza"	""	""				
"calle Ánade"	"carrer Ánade"	""	""				
"calle Alerce - Loma Espí"	"carrer Alerce - Loma Espí"	""	""				
"calle Mostajo - Loma Espí"	"carrer Mostajo - Loma Espí"	""	""				
"calle de la Acacia - Loma Espí"	"carrer de la Acacia - Loma Espí"	""	""				
"calle del Drago - Loma Espí"	"carrer del Drago - Loma Espí"	""	""				
"calle Teca - Loma Espí"	"carrer Teca - Loma Espí"	""	""				
"calle Serval - Loma Espí"	"carrer Serval - Loma Espí"	""	""				
"calle Enebro - Loma Espí"	"carrer Enebro - Loma Espí"	""	""				
"calle Tilo - Loma Espí"	"carrer Tilo - Loma Espí"	""	""				
"calle Aliso - Loma Espí"	"carrer Aliso - Loma Espí"	""	""				
"calle del Haya - Loma Espí"	"carrer del Haya - Loma Espí"	""	""				
"calle Ébano"	"carrer Ébano"	""	""				
"calle Morera - Loma Espí"	"carrer Morera - Loma Espí"	""	""				
"calle Boj - Loma Espí"	"carrer Boj - Loma Espí"	""	""				
"calle Travesía de la Fragata"	"carrer Travesía de la Fragata"	""	""				
"calle del Pato"	"carrer del Pato"	""	""				
"calle de las Tórtolas"	"carrer de las Tórtolas"	""	""				
"calle del Lusat"	"carrer del Lusat"	""	""				
"calle Setena"	"carrer Setena"	""	""				
"calle La Florida"	"carrer La Florida"	""	""				
"calle Luz"	"carrer Luz"	""	""				
"calle Principal"	"carrer Principal"	""	""				
"calle Las Rosas"	"carrer Las Rosas"	""	""				
"calle La Ermita"	"carrer La Ermita"	""	""				
"calle de las Perdices"	"carrer de las Perdices"	""	""				
"calle de los Cinco"	"carrer de los Cinco"	""	""				
"calle de Quirón"	"carrer de Quirón"	""	""				
"calle Titania"	"carrer Titania"	""	""				
"calle Miranda"	"carrer Miranda"	""	""				
"calle Palas"	"carrer Palas"	""	""				
"calle Fobos"	"carrer Fobos"	""	""				
"calle de la Cumbre"	"carrer de la Cumbre"	""	""				
"calle del Pitirojo"	"carrer del Pitirojo"	""	""				
"calle de la Gineta"	"carrer de la Gineta"	""	""				
"calle del Gorrión"	"carrer del Gorrión"	""	""				
"calle Isla de Pascua - Canyada Alcoi"	"carrer Isla de Pascua - Canyada Alcoi"	""	""				
"calle del Arpa"	"carrer del Arpa"	""	""				
"calle Sauco - Loma Espí"	"carrer Sauco - Loma Espí"	""	""				
"calle Chinchas - Canyada Alcoi"	"carrer Chinchas - Canyada Alcoi"	""	""				
"calle Islas Galápagos - Canyada Alcoi"	"carrer Islas Galápagos - Canyada Alcoi"	""	""				
"calle del Arce - Loma Espí"	"carrer del Arce - Loma Espí"	""	""				
"calle Tamboril"	"carrer Tamboril"	""	""				
"calle Tabalet"	"carrer Tabalet"	""	""				
"calle Dolçaina"	"carrer Dolçaina"	""	""				
"calle del Chistu"	"carrer del Chistu"	""	""				
"calle Islas Malpelo - Canyada Alcoi"	"carrer Islas Malpelo - Canyada Alcoi"	""	""				
"calle Islas Bermudas - Canyada Alcoi"	"carrer Islas Bermudas - Canyada Alcoi"	""	""				
"calle Islas Bahamas - Canyada Alcoi"	"carrer Islas Bahamas - Canyada Alcoi"	""	""				
"calle de Jano"	"carrer de Jano"	""	""				
"calle del Torero"	"carrer del Torero"	""	""				
"calle Juan ramón Jiménez"	"carrer Juan ramón Jiménez"	""	""				
"calle Raspeig"	"carrer Raspeig"	""	""				
"Calle Labradores"	"Carrer Labradores"	""	""				
"calle Capitán Torregrosa"	"carrer Capitán Torregrosa"	""	""				
"calle Doctor Trueta"	"carrer Doctor Trueta"	""	""				
"calle Jaume I"	"carrer Jaume I"	""	""				
"calle L'Isle d'Abeau"	"carrer L'Isle d'Abeau"	""	""				
"calle Alcalde Ramón Orts Galán"	"carrer Alcalde Ramón Orts Galán"	""	""				
"calle Algar"	"carrer Algar"	""	""				
"calle Alcalde Mariano Bevià"	"carrer Alcalde Mariano Bevià"	""	""				
"calle Alfonso X el Sabio"	"carrer Alfonso X el Sabio"	""	""				
"calle San Ramón"	"carrer San Ramón"	""	""				
"calle Calderón de La Barca"	"carrer Calderón de La Barca"	""	""				
"calle Planeta"	"carrer Planeta"	""	""				
"calle Ortiga"	"carrer Ortiga"	""	""				
"calle Río Segura"	"carrer Río Segura"	""	""				
"calle Laborinquen"	"carrer Laborinquen"	""	""				
"calle de la Balsa"	"carrer de la Balsa"	""	""				
"calle Blanca"	"carrer Blanca"	""	""				
"calle Arboleda"	"carrer Arboleda"	""	""				
"calle Trébol"	"carrer Trébol"	""	""				
"calle Brezo"	"carrer Brezo"	""	""				
"calle Algibe"	"carrer Algibe"	""	""				
"calle del Fuego"	"carrer del Fuego"	""	""				
"Calle del Pelícano"	"Carrer del Pelícano"	""	""				
"calle La Mirla"	"carrer La Mirla"	""	""				
"calle Cisne"	"carrer Cisne"	""	""				
"calle Vinalopó"	"carrer Vinalopó"	""	""				
"calle las Garzas"	"carrer las Garzas"	""	""				
"calle la Cigüeña"	"carrer la Cigüeña"	""	""				
"calle del Fresno"	"carrer del Fresno"	""	""				
"calle del Olmo"	"carrer del Olmo"	""	""				
"calle de las Moreras"	"carrer de las Moreras"	""	""				
"calle del Nogal"	"carrer del Nogal"	""	""				
"calle de la Encina"	"carrer de la Encina"	""	""				
"calle de los Pinos"	"carrer de los Pinos"	""	""				
"calle de las Zarzas"	"carrer de las Zarzas"	""	""				
"calle Verderol"	"carrer Verderol"	""	""				
"Calle las Garzas"	"Carrer las Garzas"	""	""				
"calle Los Urbanos"	"carrer Los Urbanos"	""	""				
"calle Níscalo"	"carrer Níscalo"	""	""				
"calle oreneta"	"carrer oreneta"	""	""				
"calle del Cactus"	"carrer del Cactus"	""	""				
"calle de la Mimosa"	"carrer de la Mimosa"	""	""				
"calle Espliego"	"carrer Espliego"	""	""				
"calle de las Palmeras"	"carrer de las Palmeras"	""	""				
"calle de les Salines"	"carrer de les Salines"	""	""				
"calle del Marjal"	"carrer del Marjal"	""	""				
"calle del Enebro"	"carrer del Enebro"	""	""				
"calle del Tilo"	"carrer del Tilo"	""	""				
"calle Calígula"	"carrer Calígula"	""	""				
"calle Font de Sala"	"carrer Font de Sala"	""	""				
"calle de los Limoneros"	"carrer de los Limoneros"	""	""				
"calle del Granado"	"carrer del Granado"	""	""				
"calle de los Chopos"	"carrer de los Chopos"	""	""				
"calle del Naranjo"	"carrer del Naranjo"	""	""				
"calle del Cedro"	"carrer del Cedro"	""	""				
"calle del Tomillo"	"carrer del Tomillo"	""	""				
"calle de la Yerbabuena"	"carrer de la Yerbabuena"	""	""				
"calle del Ciruelo"	"carrer del Ciruelo"	""	""				
"calle del Níspero"	"carrer del Níspero"	""	""				
"calle de la Aliaga"	"carrer de la Aliaga"	""	""				
"calle del Abeto"	"carrer del Abeto"	""	""				
"calle las Veletas"	"carrer las Veletas"	""	""				
"calle José Morote y Ramón"	"carrer José Morote y Ramón"	""	""				
"calle Maestro Lillo Varó"	"carrer Maestro Lillo Varó"	""	""				
"calle Antonia Ripoll"	"carrer Antonia Ripoll"	""	""				
"calle Juez Eduardo Ayala García"	"carrer Juez Eduardo Ayala García"	""	""				
"calle Garachico"	"carrer Garachico"	""	""				
"calle Meteorólogo Francisco García Torregrosa"	"carrer Meteorólogo Francisco García Torregrosa"	""	""				
"calle Músico Rafael Segura Galán"	"carrer Músico Rafael Segura Galán"	""	""				
"calle Músico José Torregrosa Alcaraz"	"carrer Músico José Torregrosa Alcaraz"	""	""				
"calle del Ciprés"	"carrer del Ciprés"	""	""				
"calle del Castaño"	"carrer del Castaño"	""	""				
"calle Caoba"	"carrer Caoba"	""	""				
"calle del Manzano"	"carrer del Manzano"	""	""				
"calle del Ficus"	"carrer del Ficus"	""	""				
"calle del Peral"	"carrer del Peral"	""	""				
"calle de la Violeta"	"carrer de la Violeta"	""	""				
"calle del Tulipán"	"carrer del Tulipán"	""	""				
"calle del Ébano"	"carrer del Ébano"	""	""				
"calle del Almendro"	"carrer del Almendro"	""	""				
"calle Anhidrita"	"carrer Anhidrita"	""	""				
"calle Piromorfita"	"carrer Piromorfita"	""	""				
"calle Blenda"	"carrer Blenda"	""	""				
"calle de la Sierra de Aitana"	"carrer de la Sierra de Aitana"	""	""				
"calle de la Sierra Mariola"	"carrer de la Sierra Mariola"	""	""				
"calle del Provecho"	"carrer del Provecho"	""	""				
"calle Montnegre"	"carrer Montnegre"	""	""				
"calle Arquitecto Antonio Gaudí"	"carrer Arquitecto Antonio Gaudí"	""	""				
"calle Platero y Yo"	"carrer Platero y Yo"	""	""				
"calle el Quijote"	"carrer el Quijote"	""	""				
"calle del Quinzet"	"carrer del Quinzet"	""	""				
"calle de la Sierra del Castellet"	"carrer de la Sierra del Castellet"	""	""				
"calle de Penyagolosa"	"carrer de Penyagolosa"	""	""				
"calle Alcalde José Verdú Forner"	"carrer Alcalde José Verdú Forner"	""	""				
"calle del Camí de la Rula"	"carrer del Camí de la Rula"	""	""				
"calle del Salvador"	"carrer del Salvador"	""	""				
"calle de la Acequia"	"carrer de la Acequia"	""	""				
"calle Ramón y cajal"	"carrer Ramón y cajal"	""	""				
"calle de la Soledad"	"carrer de la Soledad"	""	""				
"calle Montgó"	"carrer Montgó"	""	""				
"calle Remero Llorca"	"carrer Remero Llorca"	""	""				
"calle Dr. San Miguel Tarazona"	"carrer Dr. San Miguel Tarazona"	""	""				
"calle Mosén Pedro Mena"	"carrer Mosén Pedro Mena"	""	""				
"calle Tomás Capelo"	"carrer Tomás Capelo"	""	""				
"calle Dr. Severo Ochoa"	"carrer Dr. Severo Ochoa"	""	""				
"calle Dr. Van Der Hofstadt"	"carrer Dr. Van Der Hofstadt"	""	""				
"calle Capitán Juan Martí"	"carrer Capitán Juan Martí"	""	""				
"calle Dr. Pedro Herrero"	"carrer Dr. Pedro Herrero"	""	""				
"calle Dr. Jiménez Díaz"	"carrer Dr. Jiménez Díaz"	""	""				
"calle Navarregui"	"carrer Navarregui"	""	""				
"calle Pintor Miró"	"carrer Pintor Miró"	""	""				
"calle Constancia de la Mora"	"carrer Constancia de la Mora"	""	""				
"calle El Quijote"	"carrer El Quijote"	""	""				
"calle canónigo Federico Sala"	"carrer canónigo Federico Sala"	""	""				
"calle del Notario Salvador Montesinos"	"carrer del Notario Salvador Montesinos"	""	""				
"calle Doctor Gadea"	"carrer Doctor Gadea"	""	""				
"calle Doctor Ivorra"	"carrer Doctor Ivorra"	""	""				
"calle Manuel Amorós"	"carrer Manuel Amorós"	""	""				
"calle Pintor Baeza Gómez"	"carrer Pintor Baeza Gómez"	""	""				
"calle La Moleta"	"carrer La Moleta"	""	""				
"calle de Manolo Morán"	"carrer de Manolo Morán"	""	""				
"calle Cristo de la Paz"	"carrer Cristo de la Paz"	""	""				
"calle la Torreta"	"carrer la Torreta"	""	""				
"calle de los Naranjos"	"carrer de los Naranjos"	""	""				
"calle Maestro Bonafonte"	"carrer Maestro Bonafonte"	""	""				
"calle Madre Elisea Oliver"	"carrer Madre Elisea Oliver"	""	""				
"calle Sres. Maripino Roselló"	"carrer Sres. Maripino Roselló"	""	""				
"calle Foguerer José García"	"carrer Foguerer José García"	""	""				
"calle Doctor San Miguel Tarazona"	"carrer Doctor San Miguel Tarazona"	""	""				
"calle Fundación Vicente Ferrer"	"carrer Fundación Vicente Ferrer"	""	""				
"calle Ensenada"	"carrer Ensenada"	""	""				
"calle Hermanos Machado"	"carrer Hermanos Machado"	""	""				
"calle Francisco Seva"	"carrer Francisco Seva"	""	""				
"calle de los Álamos"	"carrer de los Álamos"	""	""				
"calle José Lamaignere"	"carrer José Lamaignere"	""	""				
"calle Pedro iturralde"	"carrer Pedro iturralde"	""	""				
"calle Dean Antonio Sala"	"carrer Dean Antonio Sala"	""	""				
"calle Los Almendros"	"carrer Los Almendros"	""	""				
"Calle Alcalde Juan Sevila"	"Carrer Alcalde Juan Sevila"	""	""				
"calle José Lamaignère"	"carrer José Lamaignère"	""	""				
"calle Carmelo Dávila"	"carrer Carmelo Dávila"	""	""				
"calle Deán Antonio Sala"	"carrer Deán Antonio Sala"	""	""				
"calle Arcadi Blasco"	"carrer Arcadi Blasco"	""	""				
"calle del Presidente Adolfo Suárez"	"carrer del Presidente Adolfo Suárez"	""	""				
"calle Cura Planelles"	"carrer Cura Planelles"	""	""				
"calle del Viento"	"carrer del Viento"	""	""				
"calle de Santa Rosa"	"carrer de Santa Rosa"	""	""				
"calle de la Ola"	"carrer de la Ola"	""	""				
"Calle Los Robles"	"Carrer Los Robles"	""	""				
"Calle Almirante"	"Carrer Almirante"	""	""				
"Calle de la Plaza de Toros"	"Carrer de la Plaza de Toros"	""	""				
"calle de la Virgen del Pilar"	"carrer de la Virgen del Pilar"	""	""				
"Calle Hnos. Pérez Lledó"	"Carrer Hnos. Pérez Lledó"	""	""				
"calle Comunidad de Castilla y León"	"carrer Comunidad de Castilla y León"	""	""				
"calle del Sagrado Corazón"	"carrer del Sagrado Corazón"	""	""				
"calle Pedro Cano"	"carrer Pedro Cano"	""	""				
"calle de Pedro Cano"	"carrer de Pedro Cano"	""	""				
"calle de Miguel Alcaraz"	"carrer de Miguel Alcaraz"	""	""				
"calle de la Estrella"	"carrer de la Estrella"	""	""				
"calle la Estrella"	"carrer la Estrella"	""	""				
"calle Rio Algar"	"carrer Rio Algar"	""	""				
"calle las Moradas"	"carrer las Moradas"	""	""				
"calle de la Ginesta"	"carrer de la Ginesta"	""	""				
"calle Tamarisco"	"carrer Tamarisco"	""	""				
"calle Hinojo"	"carrer Hinojo"	""	""				
"calle Adelfa"	"carrer Adelfa"	""	""				
"calle Virgen de Montserrat"	"carrer Virgen de Montserrat"	""	""				
"calle del Vespre"	"carrer del Vespre"	""	""				
"calle Ressol"	"carrer Ressol"	""	""				
"calle Semilla"	"carrer Semilla"	""	""				
"calle Tallo"	"carrer Tallo"	""	""				
"calle del Estambre"	"carrer del Estambre"	""	""				
"calle Hueso"	"carrer Hueso"	""	""				
"calle de la Hoja"	"carrer de la Hoja"	""	""				
"calle Montíboli"	"carrer Montíboli"	""	""				
"calle la Rama"	"carrer la Rama"	""	""				
"calle Flor"	"carrer Flor"	""	""				
"calle Antera"	"carrer Antera"	""	""				
"calle Corola"	"carrer Corola"	""	""				
"calle Terraplén"	"carrer Terraplén"	""	""				
"calle Chapitel"	"carrer Chapitel"	""	""				
"calle Rosinets"	"carrer Rosinets"	""	""				
"calle de la Hacienda"	"carrer de la Hacienda"	""	""				
"calle Tirolina"	"carrer Tirolina"	""	""				
"calle del Azufre"	"carrer del Azufre"	""	""				
"calle Cala Pinos"	"carrer Cala Pinos"	""	""				
"calle Cala de la Barca"	"carrer Cala de la Barca"	""	""				
"calle Eritina"	"carrer Eritina"	""	""				
"calle Cala Baeza"	"carrer Cala Baeza"	""	""				
"calle Cala Blanca"	"carrer Cala Blanca"	""	""				
"calle Cala Ferril"	"carrer Cala Ferril"	""	""				
"calle Cala del Mojón"	"carrer Cala del Mojón"	""	""				
"calle Cala del Charco"	"carrer Cala del Charco"	""	""				
"calle Cala la Fustera"	"carrer Cala la Fustera"	""	""				
"calle Cala de la Glea"	"carrer Cala de la Glea"	""	""				
"calle Fenaquita"	"carrer Fenaquita"	""	""				
"calle Baritina"	"carrer Baritina"	""	""				
"calle Cianita"	"carrer Cianita"	""	""				
"calle Fadaquita"	"carrer Fadaquita"	""	""				
"calle Cala Lanuza"	"carrer Cala Lanuza"	""	""				
"calle Circón"	"carrer Circón"	""	""				
"calle de las Gaviotas"	"carrer de las Gaviotas"	""	""				
"calle de los Cisnes"	"carrer de los Cisnes"	""	""				
"calle de las Garzas"	"carrer de las Garzas"	""	""				
"calle de los Faisanes"	"carrer de los Faisanes"	""	""				
"calle de las Golondrinas"	"carrer de las Golondrinas"	""	""				
"calle de los Pelícanos"	"carrer de los Pelícanos"	""	""				
"calle de los Jilgueros"	"carrer de los Jilgueros"	""	""				
"calle Riu Xúquer"	"carrer Riu Xúquer"	""	""				
"calle Río Vinalopó"	"carrer Río Vinalopó"	""	""				
"calle Rio Millares"	"carrer Rio Millares"	""	""				
"calle Rambla de Busot"	"carrer Rambla de Busot"	""	""				
"calle Barranco del Vidrier"	"carrer Barranco del Vidrier"	""	""				
"calle Riu Verd"	"carrer Riu Verd"	""	""				
"calle Parrales"	"carrer Parrales"	""	""				
"calle El Collao"	"carrer El Collao"	""	""				
"Calle Abad Juan Andrés"	"Carrer Abad Juan Andrés"	""	""				
"Calle del Marrajo"	"Carrer del Marrajo"	""	""				
"calle de la Tintorera"	"carrer de la Tintorera"	""	""				
"calle del Pez Espada"	"carrer del Pez Espada"	""	""				
"Calle del Nudo"	"Carrer del Nudo"	""	""				
"Calle de Alpa"	"Carrer de Alpa"	""	""				
"Calle del Atún"	"Carrer del Atún"	""	""				
"Calle Cherna"	"Carrer Cherna"	""	""				
"Calle de la Cherna"	"Carrer de la Cherna"	""	""				
"calle Carmelo Simón Plá"	"carrer Carmelo Simón Plá"	""	""				
"calle Peñón de Ifach"	"carrer Peñón de Ifach"	""	""				
"calle periodista Tirso Marín"	"carrer periodista Tirso Marín"	""	""				
"calle torero Luis Francisco Espla"	"carrer torero Luis Francisco Espla"	""	""				
"calle de Milán"	"carrer de Milán"	""	""				
"calle torero Vicente Blau \"El Tino\""	"carrer torero Vicente Blau \"El Tino\""	""	""				
"calle torero Francisco Antón \"Pacorro\""	"carrer torero Francisco Antón \"Pacorro\""	""	""				
"calle violonchelista Vicente Perelló Doménech"	"carrer violonchelista Vicente Perelló Doménech"	""	""				
"calle solfista Concepción Rubio"	"carrer solfista Concepción Rubio"	""	""				
"calle de Formentera"	"carrer de Formentera"	""	""				
"calle de Jacinto Benavente"	"carrer de Jacinto Benavente"	""	""				
"calle de Tabarca"	"carrer de Tabarca"	""	""				
"calle Lanzarote"	"carrer Lanzarote"	""	""				
"calle de Cartagena"	"carrer de Cartagena"	""	""				
"calle músico Vicente Spiteri"	"carrer músico Vicente Spiteri"	""	""				
"calle Calafats"	"carrer Calafats"	""	""				
"calle de Gran Canaria"	"carrer de Gran Canaria"	""	""				
"calle ibiza"	"carrer ibiza"	""	""				
"calle las Anclas"	"carrer las Anclas"	""	""				
"calle del Hierro"	"carrer del Hierro"	""	""				
"calle Fuerteventura"	"carrer Fuerteventura"	""	""				
"calle La Palma"	"carrer La Palma"	""	""				
"calle Monturiol"	"carrer Monturiol"	""	""				
"calle de Tarragona"	"carrer de Tarragona"	""	""				
"calle El Ferrol"	"carrer El Ferrol"	""	""				
"calle Moltvent Bacorera"	"carrer Moltvent Bacorera"	""	""				
"calle Alcalde José Poveda Verdú"	"carrer Alcalde José Poveda Verdú"	""	""				
"calle Versalles"	"carrer Versalles"	""	""				
"calle de los Marineros"	"carrer de los Marineros"	""	""				
"calle Hacienda del Administrador"	"carrer Hacienda del Administrador"	""	""				
"calle Montgomit"	"carrer Montgomit"	""	""				
"calle Algeciras"	"carrer Algeciras"	""	""				
"calle Magraner"	"carrer Magraner"	""	""				
"calle Xinorlet"	"carrer Xinorlet"	""	""				
"calle Llidoner"	"carrer Llidoner"	""	""				
"calle Gindoler"	"carrer Gindoler"	""	""				
"calle La Morera"	"carrer La Morera"	""	""				
"calle Galatea"	"carrer Galatea"	""	""				
"calle Hacienda d'En Mira"	"carrer Hacienda d'En Mira"	""	""				
"calle Azucena"	"carrer Azucena"	""	""				
"calle de la Niña"	"carrer de la Niña"	""	""				
"calle de las Mezquitas"	"carrer de las Mezquitas"	""	""				
"calle Hernández de Soto"	"carrer Hernández de Soto"	""	""				
"calle Francisco de Orellana"	"carrer Francisco de Orellana"	""	""				
"calle Pedro Valdivia"	"carrer Pedro Valdivia"	""	""				
"calle Sebastián de Belalcázar"	"carrer Sebastián de Belalcázar"	""	""				
"calle de la Font Roja"	"carrer de la Font Roja"	""	""				
"calle Quito Malena"	"carrer Quito Malena"	""	""				
"calle Pinta"	"carrer Pinta"	""	""				
"calle de la Font del Realet"	"carrer de la Font del Realet"	""	""				
"calle el Greco"	"carrer el Greco"	""	""				
"calle de la Rápita"	"carrer de la Rápita"	""	""				
"calle Font de l'Arc"	"carrer Font de l'Arc"	""	""				
"Calle Brazal"	"Carrer Brazal"	""	""				
"calle de la Font de Nutxes"	"carrer de la Font de Nutxes"	""	""				
"Calle la Acequia"	"Carrer la Acequia"	""	""				
"calle Font de la Cava"	"carrer Font de la Cava"	""	""				
"calle de la Font de Bugaia"	"carrer de la Font de Bugaia"	""	""				
"calle Font del Cantal"	"carrer Font del Cantal"	""	""				
"calle Font del Partagat"	"carrer Font del Partagat"	""	""				
"calle Font del Romà"	"carrer Font del Romà"	""	""				
"calle Font del la Sarsa"	"carrer Font del la Sarsa"	""	""				
"calle la Font"	"carrer la Font"	""	""				
"calle Gastón Castelló"	"carrer Gastón Castelló"	""	""				
"calle San Sebastián"	"carrer San Sebastián"	""	""				
"calle de Goya"	"carrer de Goya"	""	""				
"calle Sorolla"	"carrer Sorolla"	""	""				
"calle Roig de Corella"	"carrer Roig de Corella"	""	""				
"calle Alcalde Vicente Gomis Ramos"	"carrer Alcalde Vicente Gomis Ramos"	""	""				
"calle Doctor Oncina"	"carrer Doctor Oncina"	""	""				
"calle Maestro Pau Casals"	"carrer Maestro Pau Casals"	""	""				
"calle Maestro Óscar Esplà"	"carrer Maestro Óscar Esplà"	""	""				
"calle Aitana"	"carrer Aitana"	""	""				
"calle de la Infanta"	"carrer de la Infanta"	""	""				
"calle Pinzón"	"carrer Pinzón"	""	""				
"calle Alcalde Vaello Galiana"	"carrer Alcalde Vaello Galiana"	""	""				
"calle Cronista José Gomis Lledó"	"carrer Cronista José Gomis Lledó"	""	""				
"calle Alcalde Vicente Ramos"	"carrer Alcalde Vicente Ramos"	""	""				
"calle Alcalde Berenguer"	"carrer Alcalde Berenguer"	""	""				
"calle Alcalde Ávila"	"carrer Alcalde Ávila"	""	""				
"calle Alcalde Pepe Carratalá Navarro"	"carrer Alcalde Pepe Carratalá Navarro"	""	""				
"calle Doctor Balmis Berenguer"	"carrer Doctor Balmis Berenguer"	""	""				
"calle Alcalde Oncina Giner"	"carrer Alcalde Oncina Giner"	""	""				
"calle Trajo"	"carrer Trajo"	""	""				
"calle de Santa Teresa"	"carrer de Santa Teresa"	""	""				
"calle Roger de Lluria"	"carrer Roger de Lluria"	""	""				
"calle Alcalde Baeza Santamaría"	"carrer Alcalde Baeza Santamaría"	""	""				
"calle Manuel Sanchis Guarner"	"carrer Manuel Sanchis Guarner"	""	""				
"calle Maestro Guerrero"	"carrer Maestro Guerrero"	""	""				
"calle Maestro Amadeu Vives"	"carrer Maestro Amadeu Vives"	""	""				
"calle Maestro Granados"	"carrer Maestro Granados"	""	""				
"Calle Cancillería Real"	"Carrer Cancillería Real"	""	""				
"calle Batiste Mut"	"carrer Batiste Mut"	""	""				
"calle de la Cruz de Mayo"	"carrer de la Cruz de Mayo"	""	""				
"calle de Relleu"	"carrer de Relleu"	""	""				
"calle Villa de Marc Antoni"	"carrer Villa de Marc Antoni"	""	""				
"calle Montcabrer"	"carrer Montcabrer"	""	""				
"calle Pedro Vaello"	"carrer Pedro Vaello"	""	""				
"calle de los Leones"	"carrer de los Leones"	""	""				
"calle Vicario Samuel Riquelme"	"carrer Vicario Samuel Riquelme"	""	""				
"calle San Juan Bosco"	"carrer San Juan Bosco"	""	""				
"calle Padre Manjón"	"carrer Padre Manjón"	""	""				
"calle Vicente Payà"	"carrer Vicente Payà"	""	""				
"calle Marte"	"carrer Marte"	""	""				
"calle Neptuno"	"carrer Neptuno"	""	""				
"calle orión"	"carrer orión"	""	""				
"calle de la Marina Alta"	"carrer de la Marina Alta"	""	""				
"calle Alcalde Olcina Baeza"	"carrer Alcalde Olcina Baeza"	""	""				
"calle del Tío Galvany"	"carrer del Tío Galvany"	""	""				
"calle Curricán"	"carrer Curricán"	""	""				
"calle Plà de Sarrió"	"carrer Plà de Sarrió"	""	""				
"calle San Jorge"	"carrer San Jorge"	""	""				
"calle de San Bartolomé"	"carrer de San Bartolomé"	""	""				
"calle Carreteros"	"carrer Carreteros"	""	""				
"calle dels Algers"	"carrer dels Algers"	""	""				
"Calle de los Cipreses"	"Carrer de los Cipreses"	""	""				
"Calle de los Sauces"	"Carrer de los Sauces"	""	""				
"calle Vall de Laguar"	"carrer Vall de Laguar"	""	""				
"calle Vall de Gallinera"	"carrer Vall de Gallinera"	""	""				
"calle Vall de Ebo"	"carrer Vall de Ebo"	""	""				
"Calle de los Pinos"	"Carrer de los Pinos"	""	""				
"calle Aranjuez"	"carrer Aranjuez"	""	""				
"calle Teulada"	"carrer Teulada"	""	""				
"calle Marbella"	"carrer Marbella"	""	""				
"calle de Motril"	"carrer de Motril"	""	""				
"calle Jacarilla"	"carrer Jacarilla"	""	""				
"calle de Adra"	"carrer de Adra"	""	""				
"calle Don Carlos"	"carrer Don Carlos"	""	""				
"calle Londres"	"carrer Londres"	""	""				
"calle de Australia"	"carrer de Australia"	""	""				
"calle de Asia"	"carrer de Asia"	""	""				
"calle de Europa"	"carrer de Europa"	""	""				
"calle de Oceanía"	"carrer de Oceanía"	""	""				
"calle Amsterdam"	"carrer Amsterdam"	""	""				
"calle Bruselas"	"carrer Bruselas"	""	""				
"calle Andorra la Vella"	"carrer Andorra la Vella"	""	""				
"calle Lisboa"	"carrer Lisboa"	""	""				
"calle Viena"	"carrer Viena"	""	""				
"calle Oslo"	"carrer Oslo"	""	""				
"calle Copenhage"	"carrer Copenhage"	""	""				
"calle de África"	"carrer de África"	""	""				
"calle Ginebra"	"carrer Ginebra"	""	""				
"calle Estocolmo"	"carrer Estocolmo"	""	""				
"calle Perleta"	"carrer Perleta"	""	""				
"calle de Gales"	"carrer de Gales"	""	""				
"calle Helsinki"	"carrer Helsinki"	""	""				
"calle de Islandia"	"carrer de Islandia"	""	""				
"calle de Orihuela"	"carrer de Orihuela"	""	""				
"calle de Dolores"	"carrer de Dolores"	""	""				
"calle Xorutella"	"carrer Xorutella"	""	""				
"calle de Biar"	"carrer de Biar"	""	""				
"calle Molins"	"carrer Molins"	""	""				
"calle del Volador"	"carrer del Volador"	""	""				
"calle de Venta Lanuza"	"carrer de Venta Lanuza"	""	""				
"calle de la Rascassa"	"carrer de la Rascassa"	""	""				
"calle de l'Alacantí"	"carrer de l'Alacantí"	""	""				
"calle de la Sapla"	"carrer de la Sapla"	""	""				
"calle del Sorell"	"carrer del Sorell"	""	""				
"calle del Pagell"	"carrer del Pagell"	""	""				
"calle delTimonet"	"carrer delTimonet"	""	""				
"calle Rabo de Gato"	"carrer Rabo de Gato"	""	""				
