"name"	"name:ca"	"alt_name:ca"	"alt_name"	"translations"	"ca.wikipedia_page"	"wikidata_id"
"Calle Esturio"	"Carrer Esturio"	""	""			
"Calle Tintorera"	"Carrer Tintorera"	""	""			
"Callejero Urbanizaciones"	"Callejero Urbanizaciones"	""	""			
"Calle Almendros"	"Carrer Almendros"	""	""			
"Calle Marcelino"	"Carrer Marcelino"	""	""			
"calle de Labador"	"carrer de Labador"	""	""			
"Calle Les Forques"	"Carrer Les Forques"	""	""			
"Calle Los Cipreses"	"Carrer Los Cipreses"	""	""			
"Calle Xiprer"	"Carrer Xiprer"	""	""			
"Calle de Baix"	"Carrer de Baix"	""	""			
"Calle santa cruz"	"Carrer santa cruz"	""	""			
"Calle Vun"	"Carrer Vun"	""	""			
"Calle España la Vieja"	"Carrer España la Vieja"	""	""			
"Calle Pont"	"Carrer Pont"	""	""			
"Calle Las Rosas"	"Carrer Las Rosas"	""	""			
"Calle Margarita"	"Carrer Margarita"	""	""			
"Calle Gardenias"	"Carrer Gardenias"	""	""			
"Calle Azuzenas"	"Carrer Azuzenas"	""	""			
"Calle Los Azahares"	"Carrer Los Azahares"	""	""			
"Calle Los Jazmines"	"Carrer Los Jazmines"	""	""			
"Calle Las Romeras"	"Carrer Las Romeras"	""	""			
"Calle Los Rosales"	"Carrer Los Rosales"	""	""			
"Calle la Arboleda"	"Carrer la Arboleda"	""	""			
"Calle Los Tomillos"	"Carrer Los Tomillos"	""	""			
"Calle Las Setas"	"Carrer Las Setas"	""	""			
"Calle Camelias"	"Carrer Camelias"	""	""			
"Calle Los Claveles"	"Carrer Los Claveles"	""	""			
"Calle Los Geranios"	"Carrer Los Geranios"	""	""			
"Calle Violetas"	"Carrer Violetas"	""	""			
"Calle Los Limones"	"Carrer Los Limones"	""	""			
"Calle Las Bellotas"	"Carrer Las Bellotas"	""	""			
"Calle de la Marina Alta"	"Carrer de la Marina Alta"	""	""			
"Calle Afuera"	"Carrer Afuera"	""	""			
"Calle Labradores"	"Carrer Labradores"	""	""			
"Calle Travesía"	"Carrer Travesía"	""	""			
"calle Parras"	"carrer Parras"	""	""			
"Calle Pintor"	"Carrer Pintor"	""	""			
"Calle San José"	"Carrer San José"	""	""			
"Calle Virgen Desamparados"	"Carrer Virgen Desamparados"	""	""			
"Calle San Lorenzo"	"Carrer San Lorenzo"	""	""			
"Calle Ancha"	"Carrer Ancha"	""	""			
"Calle Salvador Dali"	"Carrer Salvador Dali"	""	""			
"Calle Monte Pego Cervantes"	"Carrer Monte Pego Cervantes"	""	""			
"Calle El Ruiseñor"	"Carrer El Ruiseñor"	""	""			
"Calle Los Naranjos"	"Carrer Los Naranjos"	""	""			
"Calle Olivos"	"Carrer Olivos"	""	""			
"Calle Golondrinas"	"Carrer Golondrinas"	""	""			
"Calle las Águilas"	"Carrer las Águilas"	""	""			
"Calle el Mirlo"	"Carrer el Mirlo"	""	""			
"Calle Monte Pego Pablo Picasso"	"Carrer Monte Pego Pablo Picasso"	""	""			
"Calle Monte Pego Machado"	"Carrer Monte Pego Machado"	""	""			
"Calle Perdices"	"Carrer Perdices"	""	""			
"Calle Los Canarios"	"Carrer Los Canarios"	""	""			
"Calle Los Algorrobos"	"Carrer Los Algorrobos"	""	""			
"Calle Los Almendros"	"Carrer Los Almendros"	""	""			
"Calle Las Encinas"	"Carrer Las Encinas"	""	""			
"Calle Los Limoneros"	"Carrer Los Limoneros"	""	""			
"Calle Patos"	"Carrer Patos"	""	""			
"Calle Patos II"	"Carrer Patos II"	""	""			
"Calle del Tennis"	"Carrer del Tennis"	""	""			
"Calle Palomas"	"Carrer Palomas"	""	""			
"Calle de los Pelicanos"	"Carrer de los Pelicanos"	""	""			
"Calle de los Patos"	"Carrer de los Patos"	""	""			
"Calle de las Cigüeñas"	"Carrer de las Cigüeñas"	""	""			
"Calle de las Gavilanes"	"Carrer de las Gavilanes"	""	""			
"Calle Tortolas"	"Carrer Tortolas"	""	""			
"Calle Unión Europea"	"Carrer Unión Europea"	""	""			
"Calle Proyecto 4"	"Carrer Proyecto 4"	""	""			
"Calle Proyecto 2"	"Carrer Proyecto 2"	""	""			
"Calle Proyecto 5"	"Carrer Proyecto 5"	""	""			
"Calle José María Ruiz Pérez-Águila"	"Carrer José María Ruiz Pérez-Águila"	"Partida Borumbot"	"Partida Borumbot"			
"Calle Capitán Zaragoza"	"Carrer Capitán Zaragoza"	""	""			
"Calle Conde de Altea"	"Carrer Conde de Altea"	""	""			
"Calle Reverendo Antonio Penalva"	"Carrer Reverendo Antonio Penalva"	""	""			
"Calle Limoneros"	"Carrer Limoneros"	""	""			
"Calle Eslovenia"	"Carrer Eslovenia"	""	""			
"Calle Estonia"	"Carrer Estonia"	""	""			
"Calle de Perera"	"Carrer de Perera"	""	""			
"Calle la Garlanda"	"Carrer la Garlanda"	""	""			
"Calle La Pimpinella"	"Carrer La Pimpinella"	""	""			
"Calle Verderol"	"Carrer Verderol"	""	""			
"Calle el Voltor"	"Carrer el Voltor"	""	""			
"Calle Puput"	"Carrer Puput"	""	""			
"Calle la Dragonera"	"Carrer la Dragonera"	""	""			
"Calle de la Ginesta"	"Carrer de la Ginesta"	""	""			
"Calle el Faisa"	"Carrer el Faisa"	""	""			
"Calle el Gavila"	"Carrer el Gavila"	""	""			
"Calle el Capsot"	"Carrer el Capsot"	""	""			
"Calle el Volador"	"Carrer el Volador"	""	""			
"Calle la Sobenera"	"Carrer la Sobenera"	""	""			
"Calle el Calamar"	"Carrer el Calamar"	""	""			
"Calle el Congre"	"Carrer el Congre"	""	""			
"Calle el Bacallar"	"Carrer el Bacallar"	""	""			
"Calle la Totena"	"Carrer la Totena"	""	""			
"Calle la Bavosa"	"Carrer la Bavosa"	""	""			
"Calle la Carpa"	"Carrer la Carpa"	""	""			
"Calle el Polp"	"Carrer el Polp"	""	""			
"Calle el Mero"	"Carrer el Mero"	""	""			
"Calle Beniares"	"Carrer Beniares"	""	""			
"Calle Haya"	"Carrer Haya"	""	""			
"Calle Buset"	"Carrer Buset"	""	""			
"Calle Tonyina"	"Carrer Tonyina"	""	""			
"Calle Llampuga"	"Carrer Llampuga"	""	""			
"Calle Buseit"	"Carrer Buseit"	""	""			
"Calle Pagell"	"Carrer Pagell"	""	""			
"Calle Cabo de la Nao"	"Carrer Cabo de la Nao"	""	""			
"Calle Cabo de Gata"	"Carrer Cabo de Gata"	""	""			
"Calle Cabo Roig"	"Carrer Cabo Roig"	""	""			
"Calle cabo de Formentor"	"Carrer cabo de Formentor"	""	""			
"Calle Cabo Finisterre"	"Carrer Cabo Finisterre"	""	""			
"Calle Cabo de Peñas"	"Carrer Cabo de Peñas"	""	""			
"Calle Cabo San Antonio"	"Carrer Cabo San Antonio"	""	""			
"Calle Dakar"	"Carrer Dakar"	""	""			
"Calle Bagdad"	"Carrer Bagdad"	""	""			
"Calle Lahore"	"Carrer Lahore"	""	""			
"Calle Estambul"	"Carrer Estambul"	""	""			
"Calle Basora"	"Carrer Basora"	""	""			
"Calle Sierra Nevada"	"Carrer Sierra Nevada"	""	""			
"Calle Mogador"	"Carrer Mogador"	""	""			
"Calle Cabo San Martin"	"Carrer Cabo San Martin"	""	""			
"Calle Amman"	"Carrer Amman"	""	""			
"Calle Jedda"	"Carrer Jedda"	""	""			
"Calle Kabul"	"Carrer Kabul"	""	""			
"Calle Damasco"	"Carrer Damasco"	""	""			
"Calle Medina"	"Carrer Medina"	""	""			
"Calle cabo de Huertas"	"Carrer cabo de Huertas"	""	""			
"Calle cabo San Vicente"	"Carrer cabo San Vicente"	""	""			
"Calle cabo Finesterre"	"Carrer cabo Finesterre"	""	""			
"Calle Bengasi"	"Carrer Bengasi"	""	""			
"Calle Asuan"	"Carrer Asuan"	""	""			
"Calle Ismailia"	"Carrer Ismailia"	""	""			
"Calle Esmirna"	"Carrer Esmirna"	""	""			
"Calle Cabo Ortegal"	"Carrer Cabo Ortegal"	""	""			
"Calle Cabo Machichaco"	"Carrer Cabo Machichaco"	""	""			
"Calle Cabo Trafalgar"	"Carrer Cabo Trafalgar"	""	""			
"Calle Cabo Salou"	"Carrer Cabo Salou"	""	""			
"Calle Cabo Salinas"	"Carrer Cabo Salinas"	""	""			
"Calle Cabo Estaca de Bares"	"Carrer Cabo Estaca de Bares"	""	""			
"Calle Cabo Norte"	"Carrer Cabo Norte"	""	""			
"Calle Timgad"	"Carrer Timgad"	""	""			
"Calle Cabo Santa Maria"	"Carrer Cabo Santa Maria"	""	""			
"Calle Maigmò"	"Carrer Maigmò"	""	""			
"Calle Orán"	"Carrer Orán"	""	""			
"Calle Larache"	"Carrer Larache"	""	""			
"Calle Casablanca"	"Carrer Casablanca"	""	""			
"Calle Meca"	"Carrer Meca"	""	""			
"Calle Alger"	"Carrer Alger"	""	""			
"Calle la Meca"	"Carrer la Meca"	""	""			
"Calle Río Sil"	"Carrer Río Sil"	""	""			
"Calle Trípoli"	"Carrer Trípoli"	""	""			
"Calle Cerro Cortina"	"Carrer Cerro Cortina"	""	""			
"Calle Ifach"	"Carrer Ifach"	""	""			
"Calle Sierra de la Carrasca"	"Carrer Sierra de la Carrasca"	""	""			
"Calle Tossal Redo"	"Carrer Tossal Redo"	""	""			
"Calle Monte Cogoll"	"Carrer Monte Cogoll"	""	""			
"Calle Mont Picayo"	"Carrer Mont Picayo"	""	""			
"Calle Riad"	"Carrer Riad"	""	""			
"Calle Beirut"	"Carrer Beirut"	""	""			
"Calle Castaño"	"Carrer Castaño"	""	""			
"Calle Eucaliptus"	"Carrer Eucaliptus"	""	""			
"Calle Manzano"	"Carrer Manzano"	""	""			
"Calle Navacerrada"	"Carrer Navacerrada"	""	""			
"Calle Río Gorgos"	"Carrer Río Gorgos"	""	""			
"Calle Montgó"	"Carrer Montgó"	""	""			
"Calle la Seldeta"	"Carrer la Seldeta"	""	""			
"Calle Naranco de Bulnes"	"Carrer Naranco de Bulnes"	""	""			
"Calle Rio Ter"	"Carrer Rio Ter"	""	""			
"Calle Roble"	"Carrer Roble"	""	""			
"Calle Olive"	"Carrer Olive"	""	""			
"Calle Benicull"	"Carrer Benicull"	""	""			
"Calle Benimagrell"	"Carrer Benimagrell"	""	""			
"Calle Benimaurell"	"Carrer Benimaurell"	""	""			
"Calle Chopo"	"Carrer Chopo"	""	""			
"Calle Río Jucar"	"Carrer Río Jucar"	""	""			
"Calle Sierra de Cazorla"	"Carrer Sierra de Cazorla"	""	""			
"Calle Río Algar"	"Carrer Río Algar"	""	""			
"Calle Granado"	"Carrer Granado"	""	""			
"Calle Cerezo"	"Carrer Cerezo"	""	""			
"Calle Laurel"	"Carrer Laurel"	""	""			
"Calle Madroño"	"Carrer Madroño"	""	""			
"Calle Peral"	"Carrer Peral"	""	""			
"Calle Cedro"	"Carrer Cedro"	""	""			
"Calle Fresno"	"Carrer Fresno"	""	""			
"Calle Rio Guadiana"	"Carrer Rio Guadiana"	""	""			
"Calle Ciprés"	"Carrer Ciprés"	""	""			
"Calle Algarrobo"	"Carrer Algarrobo"	""	""			
"Calle Acacia"	"Carrer Acacia"	""	""			
"Calle Higuera"	"Carrer Higuera"	""	""			
"Calle Sabina"	"Carrer Sabina"	""	""			
"Calle Limonero"	"Carrer Limonero"	""	""			
"Calle Río Gemil"	"Carrer Río Gemil"	""	""			
"Calle Alamo"	"Carrer Alamo"	""	""			
"Calle Naranjo"	"Carrer Naranjo"	""	""			
"Calle Cause"	"Carrer Cause"	""	""			
"Calle Montserrat"	"Carrer Montserrat"	""	""			
"Calle Urales"	"Carrer Urales"	""	""			
"Calle Monte Benicadell"	"Carrer Monte Benicadell"	""	""			
"Calle Everest"	"Carrer Everest"	""	""			
"Calle Loma de la Font Freda"	"Carrer Loma de la Font Freda"	""	""			
"Calle Alpes"	"Carrer Alpes"	""	""			
"Calle Andes"	"Carrer Andes"	""	""			
"Calle Himalaya"	"Carrer Himalaya"	""	""			
"Calle Montblanc"	"Carrer Montblanc"	""	""			
"Calle Sierra Calderona"	"Carrer Sierra Calderona"	""	""			
"Calle Puerto Pajares"	"Carrer Puerto Pajares"	""	""			
"Calle Aitana"	"Carrer Aitana"	""	""			
"Calle Coll de Rates"	"Carrer Coll de Rates"	""	""			
"Calle Teide"	"Carrer Teide"	""	""			
"Calle Sierra Espadán"	"Carrer Sierra Espadán"	""	""			
"Calle Melocotonero"	"Carrer Melocotonero"	""	""			
"Calle Encina"	"Carrer Encina"	""	""			
"Calle Gredos"	"Carrer Gredos"	""	""			
"Calle Monte Perdido"	"Carrer Monte Perdido"	""	""			
"Calle Nogal"	"Carrer Nogal"	""	""			
"Calle Enebro"	"Carrer Enebro"	""	""			
"Calle Almendro"	"Carrer Almendro"	""	""			
"Calle Olmo"	"Carrer Olmo"	""	""			
"Calle Pino"	"Carrer Pino"	""	""			
"Calle Magnolia"	"Carrer Magnolia"	""	""			
"Calle Abeto"	"Carrer Abeto"	""	""			
"Calle Benipeixcar"	"Carrer Benipeixcar"	""	""			
"Calle Benimodo"	"Carrer Benimodo"	""	""			
"Calle Benirredra"	"Carrer Benirredra"	""	""			
"Calle Benialí"	"Carrer Benialí"	""	""			
"Calle Benifayó"	"Carrer Benifayó"	""	""			
"Calle Beniatjar"	"Carrer Beniatjar"	""	""			
"Calle Benisiva"	"Carrer Benisiva"	""	""			
"Calle Benimuslem"	"Carrer Benimuslem"	""	""			
"Calle Benisili"	"Carrer Benisili"	""	""			
"Calle Benisanó"	"Carrer Benisanó"	""	""			
"Calle Zamora"	"Carrer Zamora"	""	""			
"Calle Palma de Mallorca"	"Carrer Palma de Mallorca"	""	""			
"Calle Benicolet"	"Carrer Benicolet"	""	""			
"Calle León"	"Carrer León"	""	""			
"Calle Coruña"	"Carrer Coruña"	""	""			
"Calle Santiago de Compostela"	"Carrer Santiago de Compostela"	""	""			
"Calle San Sebastián"	"Carrer San Sebastián"	""	""			
"Calle Móstoles"	"Carrer Móstoles"	""	""			
"Calle Avila"	"Carrer Avila"	""	""			
"Calle Melilla"	"Carrer Melilla"	""	""			
"Calle Logroño"	"Carrer Logroño"	""	""			
"Calle Palencia"	"Carrer Palencia"	""	""			
"Calle Lugo"	"Carrer Lugo"	""	""			
"Calle Cardiz"	"Carrer Cardiz"	""	""			
"Calle de Doctor Calatayud"	"Carrer de Doctor Calatayud"	""	""			
"Calle de les Tosqueres"	"Carrer de les Tosqueres"	""	""			
"Calle de Castillo"	"Carrer de Castillo"	""	""			
"Calle de Denia"	"Carrer de Denia"	""	""			
"Calle Puerto de Moraira"	"Carrer Puerto de Moraira"	""	""			
"Calle del Océano Antártico"	"Carrer del Océano Antártico"	""	""			
"Calle de Puerto Serrano"	"Carrer de Puerto Serrano"	""	""			
"Calle del Océano Índico"	"Carrer del Océano Índico"	""	""			
"Calle Mar de Flores"	"Carrer Mar de Flores"	""	""			
"Calle Oceano Atlantico"	"Carrer Oceano Atlantico"	""	""			
"Calle del Océano Ártico"	"Carrer del Océano Ártico"	""	""			
"Calle Flamenco"	"Carrer Flamenco"	""	""			
"Calle Puerto de Encina"	"Carrer Puerto de Encina"	""	""			
"Calle Zorzal"	"Carrer Zorzal"	""	""			
"Calle Puerto de la Cruz"	"Carrer Puerto de la Cruz"	""	""			
"Calle Puerto San Juan"	"Carrer Puerto San Juan"	""	""			
"Calle Puerto Mazarrón"	"Carrer Puerto Mazarrón"	""	""			
"Calle Frailecillo"	"Carrer Frailecillo"	""	""			
"Calle de Mar Sargazos"	"Carrer de Mar Sargazos"	""	""			
"Calle del Mar Arábigo"	"Carrer del Mar Arábigo"	""	""			
"Calle del Mar Japón"	"Carrer del Mar Japón"	""	""			
"Calle de Mar Alborán"	"Carrer de Mar Alborán"	""	""			
"Calle de Mar Negro"	"Carrer de Mar Negro"	""	""			
"Calle del Mar Norte"	"Carrer del Mar Norte"	""	""			
"Calle Mar del Labrador"	"Carrer Mar del Labrador"	""	""			
"Calle de Mar de Irlanda"	"Carrer de Mar de Irlanda"	""	""			
"Calle Mar Alborán"	"Carrer Mar Alborán"	""	""			
"Calle Mar Coral"	"Carrer Mar Coral"	""	""			
"Calle Puerto de Sta. Teresa"	"Carrer Puerto de Sta. Teresa"	""	""			
"Calle de Mar Rojo"	"Carrer de Mar Rojo"	""	""			
"Calle del Mar Báltico"	"Carrer del Mar Báltico"	""	""			
"Calle de Mar Menor"	"Carrer de Mar Menor"	""	""			
"Calle de Mar China"	"Carrer de Mar China"	""	""			
"Calle de Mar Jónico"	"Carrer de Mar Jónico"	""	""			
"Calle del Mar Egeo"	"Carrer del Mar Egeo"	""	""			
"Calle de Mar Muerto"	"Carrer de Mar Muerto"	""	""			
"Calle del Mar de Mármara"	"Carrer del Mar de Mármara"	""	""			
"Calle Mar Java"	"Carrer Mar Java"	""	""			
"Calle Mar Caribe"	"Carrer Mar Caribe"	""	""			
"Calle Becada"	"Carrer Becada"	""	""			
"Calle del Mar de Bali"	"Carrer del Mar de Bali"	""	""			
"Calle del Mar Adriático"	"Carrer del Mar Adriático"	""	""			
"Calle del Mar Aral"	"Carrer del Mar Aral"	""	""			
"Calle de Mar Caspio"	"Carrer de Mar Caspio"	""	""			
"Calle de Mar Antillas"	"Carrer de Mar Antillas"	""	""			
"Calle del Mar Behring"	"Carrer del Mar Behring"	""	""			
"Calle del Mar Blanco"	"Carrer del Mar Blanco"	""	""			
"Calle Condor"	"Carrer Condor"	""	""			
"Calle Estornino"	"Carrer Estornino"	""	""			
"Calle Gavilán"	"Carrer Gavilán"	""	""			
"Calle Puerto del Grao"	"Carrer Puerto del Grao"	""	""			
"Calle Puerto de Sóller"	"Carrer Puerto de Sóller"	""	""			
"Calle Puerto del Santa Maria"	"Carrer Puerto del Santa Maria"	""	""			
"Calle Puerto San Roque"	"Carrer Puerto San Roque"	""	""			
"Calle Puerto de Somiedo"	"Carrer Puerto de Somiedo"	""	""			
"Calle Puerto Lápice"	"Carrer Puerto Lápice"	""	""			
"Calle Puerto Andraitx"	"Carrer Puerto Andraitx"	""	""			
"Calle Mejorada"	"Carrer Mejorada"	""	""			
"Calle Puerto del Sol"	"Carrer Puerto del Sol"	""	""			
"Calle Puerto Ortigueira"	"Carrer Puerto Ortigueira"	""	""			
"Calle Puerto del Barquero"	"Carrer Puerto del Barquero"	""	""			
"Calle Puerto Puertollano"	"Carrer Puerto Puertollano"	""	""			
"Calle Puerto del Són"	"Carrer Puerto del Són"	""	""			
"Calle Puerto de Alcudia"	"Carrer Puerto de Alcudia"	""	""			
"Calle Puerto Espindola"	"Carrer Puerto Espindola"	""	""			
"Calle Puerto Fuso"	"Carrer Puerto Fuso"	""	""			
"Calle Puerto de la Laja"	"Carrer Puerto de la Laja"	""	""			
"Calle Puerto Gil"	"Carrer Puerto Gil"	""	""			
"Calle Puerto de la Heras"	"Carrer Puerto de la Heras"	""	""			
"Calle Puerto de la Luz"	"Carrer Puerto de la Luz"	""	""			
"Calle Puerto de Béjar"	"Carrer Puerto de Béjar"	""	""			
"Calle Puerto de la Madera"	"Carrer Puerto de la Madera"	""	""			
"Calle Puerto de los Cotos"	"Carrer Puerto de los Cotos"	""	""			
"Calle Puerto Lumbreras"	"Carrer Puerto Lumbreras"	""	""			
"Calle Puerto de las Castaño"	"Carrer Puerto de las Castaño"	""	""			
"Calle Puerto Alegre"	"Carrer Puerto Alegre"	""	""			
"Calle Puerto Moral"	"Carrer Puerto Moral"	""	""			
"Calle Puerto Espasante"	"Carrer Puerto Espasante"	""	""			
"Calle Puerto de Vega"	"Carrer Puerto de Vega"	""	""			
"Calle Puerto de los Morales"	"Carrer Puerto de los Morales"	""	""			
"Calle de Mar Corinto"	"Carrer de Mar Corinto"	""	""			
"Calle de Pintor Zuloaga"	"Carrer de Pintor Zuloaga"	""	""			
"Calle de Leonardo da Vinci"	"Carrer de Leonardo da Vinci"	""	""			
"Calle del Pintor Miguel Ángel"	"Carrer del Pintor Miguel Ángel"	""	""			
"Calle de Mar del iRLANDA"	"Carrer de Mar del iRLANDA"	""	""			
"Calle de Mar del Labrador"	"Carrer de Mar del Labrador"	""	""			
"Calle de Pintor Velázquez"	"Carrer de Pintor Velázquez"	""	""			
"Calle Ruiseñor"	"Carrer Ruiseñor"	""	""			
"Calle Pelícano"	"Carrer Pelícano"	""	""			
"Calle Halcón"	"Carrer Halcón"	""	""			
"Calle Perdiz"	"Carrer Perdiz"	""	""			
"Calle Milano"	"Carrer Milano"	""	""			
"Calle Búho"	"Carrer Búho"	""	""			
"Calle Cisne"	"Carrer Cisne"	""	""			
"Calle de Martin Pescador"	"Carrer de Martin Pescador"	""	""			
"Calle Águila"	"Carrer Águila"	""	""			
"Calle Gorrión"	"Carrer Gorrión"	""	""			
"Calle Alondra"	"Carrer Alondra"	""	""			
"Calle de Pintor Tápies"	"Carrer de Pintor Tápies"	""	""			
"Calle Martín Pescador"	"Carrer Martín Pescador"	""	""			
"Calle Pintor David"	"Carrer Pintor David"	""	""			
"Calle Avutarda"	"Carrer Avutarda"	""	""			
"Calle Mar de Timor"	"Carrer Mar de Timor"	""	""			
"Calle Alcolecha"	"Carrer Alcolecha"	""	""			
"Calle Pintor Van Gogh"	"Carrer Pintor Van Gogh"	""	""			
"Calle Ánade"	"Carrer Ánade"	""	""			
"Calle de Pintor Ticciano"	"Carrer de Pintor Ticciano"	""	""			
"Calle Jilguero"	"Carrer Jilguero"	""	""			
"Calle de Pintor Botticelli"	"Carrer de Pintor Botticelli"	""	""			
"Calle de Pintor Rembrant"	"Carrer de Pintor Rembrant"	""	""			
"Calle de Pintor Durero"	"Carrer de Pintor Durero"	""	""			
"Calle de Pintor Miró"	"Carrer de Pintor Miró"	""	""			
"Calle de Pintor Salvador Dalí"	"Carrer de Pintor Salvador Dalí"	""	""			
"Calle de Pintor Cezanne"	"Carrer de Pintor Cezanne"	""	""			
"Calle Golondrina"	"Carrer Golondrina"	""	""			
"Calle Albiñana"	"Carrer Albiñana"	""	""			
"Calle Albi"	"Carrer Albi"	""	""			
"Calle Colibrí"	"Carrer Colibrí"	""	""			
"Calle de Pintor Goya"	"Carrer de Pintor Goya"	""	""			
"Calle de Pintor Juan Gris"	"Carrer de Pintor Juan Gris"	""	""			
"Calle de Pintor Fortuny"	"Carrer de Pintor Fortuny"	""	""			
"Calle de Pintor Monet"	"Carrer de Pintor Monet"	""	""			
"Calle Pintor Rafael"	"Carrer Pintor Rafael"	""	""			
"Calle de Pintor Zurbarán"	"Carrer de Pintor Zurbarán"	""	""			
"Calle de Pintor Ruebens"	"Carrer de Pintor Ruebens"	""	""			
"Calle de Pintor Berruguete"	"Carrer de Pintor Berruguete"	""	""			
"Calle Azor"	"Carrer Azor"	""	""			
"Calle Garza"	"Carrer Garza"	""	""			
"Calle Faisán"	"Carrer Faisán"	""	""			
"Calle Cigüeña"	"Carrer Cigüeña"	""	""			
"Calle Puerto Rey"	"Carrer Puerto Rey"	""	""			
"Calle Algar"	"Carrer Algar"	""	""			
"Calle Magnolias"	"Carrer Magnolias"	""	""			
"Calle Zurbarán"	"Carrer Zurbarán"	""	""			
"Calle Murillo"	"Carrer Murillo"	""	""			
"Calle Paloma"	"Carrer Paloma"	""	""			
"Calle Canario"	"Carrer Canario"	""	""			
"Calle Gaviota"	"Carrer Gaviota"	""	""			
"Calle Almusafes"	"Carrer Almusafes"	""	""			
"Calle Almudaina"	"Carrer Almudaina"	""	""			
"Calle Almirante"	"Carrer Almirante"	""	""			
"Calle Santa Cruz"	"Carrer Santa Cruz"	""	""			
"calle San Roque"	"carrer San Roque"	""	""			
"Calle Travesia el Pla"	"Carrer Travesia el Pla"	""	""			
"Calle del Doctor Torrent"	"Carrer del Doctor Torrent"	""	""			
"Calle de Parcent"	"Carrer de Parcent"	""	""			
"Calle del Doctor José Pitarch"	"Carrer del Doctor José Pitarch"	""	""			
"Calle de Tárbena"	"Carrer de Tárbena"	""	""			
"Calle de Benassau"	"Carrer de Benassau"	""	""			
"Calle de Ondara"	"Carrer de Ondara"	""	""			
"Calle de Jesmiler"	"Carrer de Jesmiler"	""	""			
"Calle de San Vicente Ferrer"	"Carrer de San Vicente Ferrer"	""	""			
"Calle de Pedreguer"	"Carrer de Pedreguer"	""	""			
"Calle de la Gata de Gorgos"	"Carrer de la Gata de Gorgos"	""	""			
"Calle de Alacant"	"Carrer de Alacant"	""	""			
"Calle Roquetes"	"Carrer Roquetes"	""	""			
"Calle de Hermanas Oliver"	"Carrer de Hermanas Oliver"	""	""			
"Calle de Ibiza"	"Carrer de Ibiza"	""	""			
"Calle de Calvo Sotelo"	"Carrer de Calvo Sotelo"	""	""			
"Calle del Doctor Moll"	"Carrer del Doctor Moll"	""	""			
"Calle de la Divina Pastora"	"Carrer de la Divina Pastora"	""	""			
"Calle de la Costereta del Campanar"	"Carrer de la Costereta del Campanar"	""	""			
"Calle del Hostal"	"Carrer del Hostal"	""	""			
"Calle de Arriba"	"Carrer de Arriba"	""	""			
"Calle de Vives"	"Carrer de Vives"	""	""			
"Calle de San Buenaventura"	"Carrer de San Buenaventura"	""	""			
"Calle de Canonge Valles"	"Carrer de Canonge Valles"	""	""			
"Calle de Senija"	"Carrer de Senija"	""	""			
"Calle de Jávea"	"Carrer de Jávea"	""	""			
"Calle del Maestro Mulet Borrell"	"Carrer del Maestro Mulet Borrell"	""	""			
"Calle la Marjal de Pego–Oliva"	"Carrer la Marjal de Pego–Oliva"	""	""			
"Calle de Salamanca"	"Carrer de Salamanca"	""	""			
"Calle Pere Rois de Corella"	"Carrer Pere Rois de Corella"	""	""			
"Calle de la Rosa"	"Carrer de la Rosa"	""	""			
"Calle Argentina"	"Carrer Argentina"	""	""			
"Calle Jeremías Andrés"	"Carrer Jeremías Andrés"	""	""			
"Calle Palmeral Alto"	"Carrer Palmeral Alto"	""	""			
"Calle San Jose"	"Carrer San Jose"	""	""			
"calle Peñón"	"carrer Peñón"	""	""			
"calle del grupo escolar"	"carrer del grupo escolar"	""	""			
"calle Duquesa de Almodovar"	"carrer Duquesa de Almodovar"	""	""			
"Calle Alcolaes"	"Carrer Alcolaes"	""	""			
"Calle San Vicente"	"Carrer San Vicente"	""	""			
"Calle Palmeral"	"Carrer Palmeral"	""	""			
"Calle Tetuán"	"Carrer Tetuán"	""	""			
"Calle Palmeral Bajo"	"Carrer Palmeral Bajo"	""	""			
"Calle Duquesa de Almodovar"	"Carrer Duquesa de Almodovar"	""	""			
"Calle Jesús Pobre"	"Carrer Jesús Pobre"	""	""			
"Calle Cruz del Sur"	"Carrer Cruz del Sur"	""	""			
"Calle Camaleón"	"Carrer Camaleón"	""	""			
"Calle de Benissa"	"Carrer de Benissa"	""	""			
"Calle de Liber"	"Carrer de Liber"	""	""			
"Calle de la Juventud"	"Carrer de la Juventud"	""	""			
"Calle de Clementina Bertomeu"	"Carrer de Clementina Bertomeu"	""	""			
"Calle de Altea"	"Carrer de Altea"	""	""			
"Calle de Calpe"	"Carrer de Calpe"	""	""			
"Calle de Guadalest"	"Carrer de Guadalest"	""	""			
"Calle Alcantara"	"Carrer Alcantara"	""	""			
"Calle Alcalali"	"Carrer Alcalali"	""	""			
"Calle Alfafar"	"Carrer Alfafar"	""	""			
"Calle Mar Baltico"	"Carrer Mar Baltico"	""	""			
"Calle Vistamar"	"Carrer Vistamar"	""	""			
"Calle Adelfas"	"Carrer Adelfas"	""	""			
"Calle Frederik de Klerk"	"Carrer Frederik de Klerk"	""	""			
"Calle Fresnos"	"Carrer Fresnos"	""	""			
"Calle Desmond Tutu"	"Carrer Desmond Tutu"	""	""			
"Calle Nelson Mandela"	"Carrer Nelson Mandela"	""	""			
"Calle Thomas Wilson"	"Carrer Thomas Wilson"	""	""			
"Calle Joseph Rotblat"	"Carrer Joseph Rotblat"	""	""			
"Calle Madre Teresa"	"Carrer Madre Teresa"	""	""			
"Calle Jean Arp"	"Carrer Jean Arp"	""	""			
"Calle Alberto Durero"	"Carrer Alberto Durero"	""	""			
"Calle Jean Ingres"	"Carrer Jean Ingres"	""	""			
"Calle Fernando Leger"	"Carrer Fernando Leger"	""	""			
"Calle Paul Klee"	"Carrer Paul Klee"	""	""			
"Calle Rosa Bonheur"	"Carrer Rosa Bonheur"	""	""			
"Calle Pablo Céspedes"	"Carrer Pablo Céspedes"	""	""			
"Calle Frans Hals"	"Carrer Frans Hals"	""	""			
"Calle del Lago Como"	"Carrer del Lago Como"	""	""			
"Calle del Lago Tanganyka"	"Carrer del Lago Tanganyka"	""	""			
"calle del lago como"	"carrer del lago como"	""	""			
"Calle Lago Kivu"	"Carrer Lago Kivu"	""	""			
"Calle del Lago Tana"	"Carrer del Lago Tana"	""	""			
"Calle del lago como"	"Carrer del lago como"	""	""			
"calle del lago ginebra"	"carrer del lago ginebra"	""	""			
"Calle de lago Vanern"	"Carrer de lago Vanern"	""	""			
"Calle Rio Cuervo"	"Carrer Rio Cuervo"	""	""			
"Calle Rio Amadorio"	"Carrer Rio Amadorio"	""	""			
"Calle Rio Segura"	"Carrer Rio Segura"	""	""			
"Calle del Lago Superior"	"Carrer del Lago Superior"	""	""			
"Calle Rio Serpis"	"Carrer Rio Serpis"	""	""			
"Calle Rio Milares"	"Carrer Rio Milares"	""	""			
"Calle Río Vinalopó"	"Carrer Río Vinalopó"	""	""			
"Calle Honoré Daumier"	"Carrer Honoré Daumier"	""	""			
"Calle Marcel Ducham"	"Carrer Marcel Ducham"	""	""			
"Calle Francis Bacon"	"Carrer Francis Bacon"	""	""			
"Calle Apeles"	"Carrer Apeles"	""	""			
"Calle Tintoretto"	"Carrer Tintoretto"	""	""			
"Calle Andrea del Sarto"	"Carrer Andrea del Sarto"	""	""			
"Calle Amelia Pelaez"	"Carrer Amelia Pelaez"	""	""			
"Calle Andrea Di Bartolo"	"Carrer Andrea Di Bartolo"	""	""			
"Calle Paul Cezanne"	"Carrer Paul Cezanne"	""	""			
"Calle Miguel Cabrera"	"Carrer Miguel Cabrera"	""	""			
"Calle Alberto Burri"	"Carrer Alberto Burri"	""	""			
"Calle Angelo Nardi"	"Carrer Angelo Nardi"	""	""			
"Calle Paolo Veronese"	"Carrer Paolo Veronese"	""	""			
"Calle Maurice Utrillo"	"Carrer Maurice Utrillo"	""	""			
"Calle Rembrandt"	"Carrer Rembrandt"	""	""			
"Calle Juan Echeverria"	"Carrer Juan Echeverria"	""	""			
"Calle del Naranjo"	"Carrer del Naranjo"	""	""			
"Calle del Fresno"	"Carrer del Fresno"	""	""			
"Calle del Abeto"	"Carrer del Abeto"	""	""			
"Calle de la Palmera"	"Carrer de la Palmera"	""	""			
"Calle del Castaño"	"Carrer del Castaño"	""	""			
"Calle del Madroño"	"Carrer del Madroño"	""	""			
"Calle Cogullada"	"Carrer Cogullada"	""	""			
"Calle Merla"	"Carrer Merla"	""	""			
"Calle Mirlos"	"Carrer Mirlos"	""	""			
"Calle Halcones"	"Carrer Halcones"	""	""			
"Calle Tordos"	"Carrer Tordos"	""	""			
"Calle del Cerezo"	"Carrer del Cerezo"	""	""			
"Calle Faisanes"	"Carrer Faisanes"	""	""			
"Calle del Parpalló"	"Carrer del Parpalló"	""	""			
"Calle Cigüeñas"	"Carrer Cigüeñas"	""	""			
"Calle Gaviotas"	"Carrer Gaviotas"	""	""			
"Calle Sandro Botticell"	"Carrer Sandro Botticell"	""	""			
"Calle Toulouse-Lautrec"	"Carrer Toulouse-Lautrec"	""	""			
"Calle Gram"	"Carrer Gram"	""	""			
"Calle Hedra"	"Carrer Hedra"	""	""			
"Calle Baladre"	"Carrer Baladre"	""	""			
"Calle Falguera"	"Carrer Falguera"	""	""			
"Calle del Pino"	"Carrer del Pino"	""	""			
"Calle del Sauce"	"Carrer del Sauce"	""	""			
"Calle del Álamo"	"Carrer del Álamo"	""	""			
"Calle del Nogal"	"Carrer del Nogal"	""	""			
"Calle Belladona"	"Carrer Belladona"	""	""			
"Calle del Enebro"	"Carrer del Enebro"	""	""			
"Calle de la Kentia"	"Carrer de la Kentia"	""	""			
"Calle Aloe"	"Carrer Aloe"	""	""			
"Calle del Algarrobo"	"Carrer del Algarrobo"	""	""			
"calle Orquidea"	"carrer Orquidea"	""	""			
"Calle Noguera"	"Carrer Noguera"	""	""			
"Calle Campaneta"	"Carrer Campaneta"	""	""			
"Calle Nesprer"	"Carrer Nesprer"	""	""			
"Calle Parra"	"Carrer Parra"	""	""			
"Calle Henri Mathis"	"Carrer Henri Mathis"	""	""			
"Calle del Ciclamen"	"Carrer del Ciclamen"	""	""			
"Calle Prunera"	"Carrer Prunera"	""	""			
"Calle Caléndula"	"Carrer Caléndula"	""	""			
"Calle Anemone"	"Carrer Anemone"	""	""			
"Calle Fucsia"	"Carrer Fucsia"	""	""			
"Calle del Almendro"	"Carrer del Almendro"	""	""			
"Calle del Rosal"	"Carrer del Rosal"	""	""			
"Calle del Tulipán"	"Carrer del Tulipán"	""	""			
"Calle de la Madreselva"	"Carrer de la Madreselva"	""	""			
"Calle del Helecho"	"Carrer del Helecho"	""	""			
"Calle Águilas"	"Carrer Águilas"	""	""			
"Calle Azores"	"Carrer Azores"	""	""			
"Calle Ruiseñores"	"Carrer Ruiseñores"	""	""			
"Calle del Avellano"	"Carrer del Avellano"	""	""			
"Calle Jacinto"	"Carrer Jacinto"	""	""			
"Calle Dalia"	"Carrer Dalia"	""	""			
"Calle Pebrella"	"Carrer Pebrella"	""	""			
"Calle Ortiga"	"Carrer Ortiga"	""	""			
"Calle Timo"	"Carrer Timo"	""	""			
"Calle Cactus"	"Carrer Cactus"	""	""			
"Calle Begonia"	"Carrer Begonia"	""	""			
"Calle Tripoli"	"Carrer Tripoli"	""	""			
"Calle Murciana"	"Carrer Murciana"	""	""			
"Calle del Hibiscus"	"Carrer del Hibiscus"	""	""			
"Calle Petunia"	"Carrer Petunia"	""	""			
"Calle del Romero"	"Carrer del Romero"	""	""			
"Calle del Tomillo"	"Carrer del Tomillo"	""	""			
"Calle de la Retama"	"Carrer de la Retama"	""	""			
"Calle Esparta"	"Carrer Esparta"	""	""			
"Calle Agulla"	"Carrer Agulla"	""	""			
"Calle Api"	"Carrer Api"	""	""			
"Calle Margallo"	"Carrer Margallo"	""	""			
"Calle Congre"	"Carrer Congre"	""	""			
"Calle de Olivera"	"Carrer de Olivera"	""	""			
"Calle de la Adelfa"	"Carrer de la Adelfa"	""	""			
"Calle de la Gardenia"	"Carrer de la Gardenia"	""	""			
"Calle del Chopo"	"Carrer del Chopo"	""	""			
"Calle del Ciprés"	"Carrer del Ciprés"	""	""			
"Calle Pitera"	"Carrer Pitera"	""	""			
"Calle Safanoria"	"Carrer Safanoria"	""	""			
"Calle Japon"	"Carrer Japon"	""	""			
"Calle Groenlandia"	"Carrer Groenlandia"	""	""			
"Calle Rio Jiloca"	"Carrer Rio Jiloca"	""	""			
"Calle Mar Celtico"	"Carrer Mar Celtico"	""	""			
"Calle Rio Cabriel"	"Carrer Rio Cabriel"	""	""			
"Calle Río Carbó"	"Carrer Río Carbó"	""	""			
"Calle Mar de Kara"	"Carrer Mar de Kara"	""	""			
"Calle Republica Dominicana"	"Carrer Republica Dominicana"	""	""			
"Calle Chile"	"Carrer Chile"	""	""			
"Calle Peru"	"Carrer Peru"	""	""			
"Calle Leon"	"Carrer Leon"	""	""			
"Calle Castellon"	"Carrer Castellon"	""	""			
"Calle Ecuador"	"Carrer Ecuador"	""	""			
"Calle Uruguay"	"Carrer Uruguay"	""	""			
"Calle Corona Boreal"	"Carrer Corona Boreal"	""	""			
"Calle Cabellera de Berenice"	"Carrer Cabellera de Berenice"	""	""			
"Calle Acuario"	"Carrer Acuario"	""	""			
"Calle Canes de Caza"	"Carrer Canes de Caza"	""	""			
"Calle Leo"	"Carrer Leo"	""	""			
"Calle Tauro"	"Carrer Tauro"	""	""			
"Calle Bulino"	"Carrer Bulino"	""	""			
"Calle Unicornio"	"Carrer Unicornio"	""	""			
"Calle Hércules"	"Carrer Hércules"	""	""			
"Calle Pegaso"	"Carrer Pegaso"	""	""			
"Calle Piscis"	"Carrer Piscis"	""	""			
"Calle Singapur"	"Carrer Singapur"	""	""			
"Calle Indonesia"	"Carrer Indonesia"	""	""			
"Calle La India"	"Carrer La India"	""	""			
"Calle Estrella Polar"	"Carrer Estrella Polar"	""	""			
"Calle Mizar"	"Carrer Mizar"	""	""			
"Calle Brújula"	"Carrer Brújula"	""	""			
"Calle de Nunki"	"Carrer de Nunki"	""	""			
"Calle Perseo"	"Carrer Perseo"	""	""			
"Calle de Lebreles"	"Carrer de Lebreles"	""	""			
"Calle de la Hidra"	"Carrer de la Hidra"	""	""			
"Calle de Acamar"	"Carrer de Acamar"	""	""			
"Calle Sagitario"	"Carrer Sagitario"	""	""			
"Calle Osa Menor"	"Carrer Osa Menor"	""	""			
"Calle Bermudas"	"Carrer Bermudas"	""	""			
"Calle Piezarroya"	"Carrer Piezarroya"	""	""			
"Calle Muela"	"Carrer Muela"	""	""			
"Calle Tejo"	"Carrer Tejo"	""	""			
"Calle de Antares"	"Carrer de Antares"	""	""			
"Calle de Algol"	"Carrer de Algol"	""	""			
"Calle Ofiuco"	"Carrer Ofiuco"	""	""			
"Calle Ascella"	"Carrer Ascella"	""	""			
"Calle Octante"	"Carrer Octante"	""	""			
"Calle Ares"	"Carrer Ares"	""	""			
"Calle Libra"	"Carrer Libra"	""	""			
"Calle Capricornio"	"Carrer Capricornio"	""	""			
"Calle de Piscis"	"Carrer de Piscis"	""	""			
"Calle Centauro"	"Carrer Centauro"	""	""			
"Calle Can Mayor"	"Carrer Can Mayor"	""	""			
"Calle Cefeo"	"Carrer Cefeo"	""	""			
"Calle de Cáncer"	"Carrer de Cáncer"	""	""			
"Calle de Auriga"	"Carrer de Auriga"	""	""			
"Calle de Casiopea"	"Carrer de Casiopea"	""	""			
"Calle de Montalbana"	"Carrer de Montalbana"	""	""			
"Calle Mola del Carrascar"	"Carrer Mola del Carrascar"	""	""			
"Calle Mola del Murar"	"Carrer Mola del Murar"	""	""			
"Calle Atalaya del Sabinar"	"Carrer Atalaya del Sabinar"	""	""			
"Calle Montemayor"	"Carrer Montemayor"	""	""			
"Calle Viella"	"Carrer Viella"	""	""			
"Calle Langreo"	"Carrer Langreo"	""	""			
"Calle Tolosa"	"Carrer Tolosa"	""	""			
"Calle Lastres"	"Carrer Lastres"	""	""			
"Calle Torre Capsades"	"Carrer Torre Capsades"	""	""			
"Calle Sharq Al-Andalus"	"Carrer Sharq Al-Andalus"	""	""			
"Calle Side Ghali"	"Carrer Side Ghali"	""	""			
"Calle Puerta Fenicia"	"Carrer Puerta Fenicia"	""	""			
"Calle Ibn Al-Abbar"	"Carrer Ibn Al-Abbar"	""	""			
"Calle Carlos Baca-Flor"	"Carrer Carlos Baca-Flor"	""	""			
"Calle Francisco Zurbarán"	"Carrer Francisco Zurbarán"	""	""			
"Calle Pedro Berruguete"	"Carrer Pedro Berruguete"	""	""			
"Calle Juan de Borgoña"	"Carrer Juan de Borgoña"	""	""			
"Calle Francisco Herrera"	"Carrer Francisco Herrera"	""	""			
"Calle Ramón Casas"	"Carrer Ramón Casas"	""	""			
"Calle Francisco de Goya"	"Carrer Francisco de Goya"	""	""			
"Calle María Izquierdo"	"Carrer María Izquierdo"	""	""			
"Calle Fernando Botero"	"Carrer Fernando Botero"	""	""			
"Calle Antonio Beni"	"Carrer Antonio Beni"	""	""			
"Calle de Benarribat"	"Carrer de Benarribat"	""	""			
"Calle Bartolomé Sebastián Murillo"	"Carrer Bartolomé Sebastián Murillo"	""	""			
"Calle Canaletto"	"Carrer Canaletto"	""	""			
"Calle Bruselas"	"Carrer Bruselas"	""	""			
"Calle Cronista Mosén Febrer"	"Carrer Cronista Mosén Febrer"	""	""			
"Calle Victor Candela"	"Carrer Victor Candela"	""	""			
"Calle Virgen de la Merced"	"Carrer Virgen de la Merced"	""	""			
"Calle Guerrillero Campaner"	"Carrer Guerrillero Campaner"	""	""			
"Calle San Antonio"	"Carrer San Antonio"	""	""			
"Calle Cagliari"	"Carrer Cagliari"	""	""			
"Calle Burdeos"	"Carrer Burdeos"	""	""			
"Calle Liverpool"	"Carrer Liverpool"	""	""			
"Calle La Haya"	"Carrer La Haya"	""	""			
"Calle Amsterdam"	"Carrer Amsterdam"	""	""			
"Calle Diego Rivera"	"Carrer Diego Rivera"	""	""			
"Calle Eduardo Abella"	"Carrer Eduardo Abella"	""	""			
"Calle de la Esparraguera"	"Carrer de la Esparraguera"	""	""			
"Calle Meteora"	"Carrer Meteora"	""	""			
"Calle Miconos"	"Carrer Miconos"	""	""			
"Calle Tesalónica"	"Carrer Tesalónica"	""	""			
"Calle Niza"	"Carrer Niza"	""	""			
"Calle Saint Tropez"	"Carrer Saint Tropez"	""	""			
"Calle Salónica"	"Carrer Salónica"	""	""			
"Calle Rodas"	"Carrer Rodas"	""	""			
"Calle Delfos"	"Carrer Delfos"	""	""			
"Calle Patrai"	"Carrer Patrai"	""	""			
"Calle Egina"	"Carrer Egina"	""	""			
"Calle Larissa"	"Carrer Larissa"	""	""			
"Calle de Pisa"	"Carrer de Pisa"	""	""			
"Calle Bari"	"Carrer Bari"	""	""			
"Calle de Génova"	"Carrer de Génova"	""	""			
"Calle Marsella"	"Carrer Marsella"	""	""			
"Calle San Bartolomé"	"Carrer San Bartolomé"	""	""			
"Calle San Isidro"	"Carrer San Isidro"	""	""			
"Calle Sta. Marta"	"Carrer Sta. Marta"	""	""			
"Calle Thiviers"	"Carrer Thiviers"	""	""			
"Calle Arquitecto Urteaga"	"Carrer Arquitecto Urteaga"	""	""			
"Calle lquera Blanca"	"Carrer lquera Blanca"	""	""			
"Calle Almedíjar"	"Carrer Almedíjar"	""	""			
"Calle de Jorge Luis Borges"	"Carrer de Jorge Luis Borges"	""	""			
"Calle Verona"	"Carrer Verona"	""	""			
"Calle Bolonia"	"Carrer Bolonia"	""	""			
"Calle Caleta"	"Carrer Caleta"	""	""			
"Calle Bar"	"Carrer Bar"	""	""			
"Calle Santísimo Cristo del Mar"	"Carrer Santísimo Cristo del Mar"	""	""			
"Calle Fray Jaime Ibáñez"	"Carrer Fray Jaime Ibáñez"	""	""			
"Calle la Mezquida"	"Carrer la Mezquida"	""	""			
"Calle Pío X"	"Carrer Pío X"	""	""			
"Calle del Capitán Pedro-Soler"	"Carrer del Capitán Pedro-Soler"	""	""			
"Calle Ibi"	"Carrer Ibi"	""	""			
"Calle Andrés Lambert"	"Carrer Andrés Lambert"	""	""			
"Calle Cuesta de San Antonio"	"Carrer Cuesta de San Antonio"	""	""			
"Calle de Richard Wagner"	"Carrer de Richard Wagner"	""	""			
"Calle de Samuel Adler"	"Carrer de Samuel Adler"	""	""			
"Calle Torlit"	"Carrer Torlit"	""	""			
"Calle José Ardévol"	"Carrer José Ardévol"	""	""			
"Calle de Louis Armstrong"	"Carrer de Louis Armstrong"	""	""			
"Calle de Paul Dukas"	"Carrer de Paul Dukas"	""	""			
"Calle de Juan Carlos Pau"	"Carrer de Juan Carlos Pau"	""	""			
"Calle de Amadeo Roldán"	"Carrer de Amadeo Roldán"	""	""			
"Calle Tordanxa"	"Carrer Tordanxa"	""	""			
"Calle de la Picarasa"	"Carrer de la Picarasa"	""	""			
"Calle de Georges Bizet"	"Carrer de Georges Bizet"	""	""			
"Calle de Frederic Chopin"	"Carrer de Frederic Chopin"	""	""			
"Calle de Johann Strauss"	"Carrer de Johann Strauss"	""	""			
"Calle de Isaac Albéniz"	"Carrer de Isaac Albéniz"	""	""			
"Calle de S. Revueltas"	"Carrer de S. Revueltas"	""	""			
"Calle de Johannes Brahms"	"Carrer de Johannes Brahms"	""	""			
"Calle de Robert Schumann"	"Carrer de Robert Schumann"	""	""			
"Calle de D. Escarvalati"	"Carrer de D. Escarvalati"	""	""			
"Calle Claude Debussy"	"Carrer Claude Debussy"	""	""			
"Calle Ludwig van Beethoven"	"Carrer Ludwig van Beethoven"	""	""			
"Calle de George Gershwin"	"Carrer de George Gershwin"	""	""			
"Calle de Edward Grieg"	"Carrer de Edward Grieg"	""	""			
"Calle de Joaquín Rodrigo"	"Carrer de Joaquín Rodrigo"	""	""			
"Calle Hector Berlioz"	"Carrer Hector Berlioz"	""	""			
"Calle de la Rascassa"	"Carrer de la Rascassa"	""	""			
"Calle de la Truita"	"Carrer de la Truita"	""	""			
"Calle de Joaquin Rodrigo"	"Carrer de Joaquin Rodrigo"	""	""			
"Calle José Casanovas"	"Carrer José Casanovas"	""	""			
"Calle de Carl Nielsen"	"Carrer de Carl Nielsen"	""	""			
"Calle de Antonio Vivaldi"	"Carrer de Antonio Vivaldi"	""	""			
"Calle Johann S. Bach"	"Carrer Johann S. Bach"	""	""			
"Calle Georg Friedrich Haendel"	"Carrer Georg Friedrich Haendel"	""	""			
"Calle de Manuel de Falla"	"Carrer de Manuel de Falla"	""	""			
"Calle Falzia"	"Carrer Falzia"	""	""			
"Calle Edgar Varése"	"Carrer Edgar Varése"	""	""			
"Calle Luigi Bocherini"	"Carrer Luigi Bocherini"	""	""			
"Calle de Anton Webern"	"Carrer de Anton Webern"	""	""			
"Calle de Cristóbal Halffter"	"Carrer de Cristóbal Halffter"	""	""			
"Calle de Jaques Offenbach"	"Carrer de Jaques Offenbach"	""	""			
"Calle Giachino Rossini"	"Carrer Giachino Rossini"	""	""			
"Calle de Leonard Bernstein"	"Carrer de Leonard Bernstein"	""	""			
"Calle de Felix Mendelson"	"Carrer de Felix Mendelson"	""	""			
"Calle de Bela Bartok"	"Carrer de Bela Bartok"	""	""			
"Calle de Henry Purcell"	"Carrer de Henry Purcell"	""	""			
"Calle F. Gaspanni"	"Carrer F. Gaspanni"	""	""			
"Calle de Franz Joseph Haydn"	"Carrer de Franz Joseph Haydn"	""	""			
"Calle Giacomo Puchini"	"Carrer Giacomo Puchini"	""	""			
"Calle Gustav Mahler"	"Carrer Gustav Mahler"	""	""			
"Calle de Claudio Monteverdi"	"Carrer de Claudio Monteverdi"	""	""			
"Calle de Felix Mendelssohn"	"Carrer de Felix Mendelssohn"	""	""			
"Calle de Pierre Boulez"	"Carrer de Pierre Boulez"	""	""			
"Calle Louis de Pablo"	"Carrer Louis de Pablo"	""	""			
"Calle de W.A. Mozart"	"Carrer de W.A. Mozart"	""	""			
"Calle de Charles Ives"	"Carrer de Charles Ives"	""	""			
"Calle de Nicolo Paganini"	"Carrer de Nicolo Paganini"	""	""			
"Calle Gabriel Fauré"	"Carrer Gabriel Fauré"	""	""			
"Calle de Franz List"	"Carrer de Franz List"	""	""			
"Calle de Carlos Chávez"	"Carrer de Carlos Chávez"	""	""			
"Calle de Luciano Berio"	"Carrer de Luciano Berio"	""	""			
"Calle de Benjamin Britten"	"Carrer de Benjamin Britten"	""	""			
"Calle Dacsa"	"Carrer Dacsa"	""	""			
"Calle Jolivert"	"Carrer Jolivert"	""	""			
"Calle Sardina"	"Carrer Sardina"	""	""			
"Calle Samarus"	"Carrer Samarus"	""	""			
"Calle Ceba"	"Carrer Ceba"	""	""			
"Calle Celiandre"	"Carrer Celiandre"	""	""			
"Calle Joan Fusier"	"Carrer Joan Fusier"	""	""			
"Calle Cecilio Gallego Arias"	"Carrer Cecilio Gallego Arias"	""	""			
"Calle Mariano Benlliure"	"Carrer Mariano Benlliure"	""	""			
