"name"	"name:ca"	"alt_name:ca"	"alt_name"	"translations"	"ca.wikipedia_page"	"wikidata_id"
"Camino Del Calvario"	"Camí Del Calvario"					
"Camino de la Venta"	"Camí de la Venta"					
"Camino del Barranco"	"Camí del Barranco"					
"Camino del Pozo"	"Camí del Pozo"					
"Camino de la Fuente"	"Camí de la Fuente"					
"Camino del Pantano"	"Camí del Pantano"					
"Camino del Calvario"	"Camí del Calvario"					
"Camino del Ulldemó"	"Camí del Ulldemó"					
"Camino de Mazaleón a Valdealgorfa;La Vall"	"Camí de Mazaleón a Valdealgorfa;La Vall"					
"Camino Agüera de Balsa"	"Camí Agüera de Balsa"					
"Camino Natural Via Verde Val de Zafán. Tramo Val de Zafán"	"Camí Natural Via Verde Val de Zafán. Tramo Val de Zafán"					
"Camino Natural del Matarraña - Algars"	"Camí Natural del Matarraña - Algars"					
"camino del Callet"	"camí del Callet"					
"Camino ermita San Andrés"	"Camí ermita San Andrés"					
"camino a Juseu de Ardós"	"camí a Juseu de Ardós"					
"Camino a Purroi de Calasanz"	"Camí a Purroi de Calasanz"					
"Camino de los Masets"	"Camí de los Masets"					
"Camino Juseu-Purroy/GR-18"	"Camí Juseu-Purroy/GR-18"					
"Camino a Aler"	"Camí a Aler"					
"Camino Torres del Obispo-Aler"	"Camí Torres del Obispo-Aler"					
"Camino Juseu-Purroy"	"Camí Juseu-Purroy"					
"camino ermita Sta. Ana"	"camí ermita Sta. Ana"					
"Camino a Benbarre"	"Camí a Benbarre"					
"Camino del Cementerio"	"Camí del Cementerio"					
"Camino Besague"	"Camí Besague"					
"Camino del Molino"	"Camí del Molino"					
"Camino Cemeterio"	"Camí Cemeterio"					
"Camino de Lascuarre"	"Camí de Lascuarre"					
"Camino de Montfalcó al Congost de Montrebei"	"Camí de Montfalcó al Congost de Montrebei"					
"Camino La Pilar"	"Camí La Pilar"					
"Camino Sarradal"	"Camí Sarradal"					
"Camino Villarué"	"Camí Villarué"					
"Camino del Monzón"	"Camí del Monzón"					
"Camino de Altorricón"	"Camí de Altorricón"					
"Camino de Baélls"	"Camí de Baélls"					
"Camino de Rafalés"	"Camí de Rafalés"					
"Camino Cuquet"	"Camí Cuquet"					
"Camino San Jaime"	"Camí San Jaime"					
"Camino de Michans"	"Camí de Michans"					
"Camino de Monzon"	"Camí de Monzon"					
"Camino de Alcampel"	"Camí de Alcampel"					
"Camino Pallero Puig"	"Camí Pallero Puig"					
"Camino Extramuros"	"Camí Extramuros"					
"Camino Santa Margarita"	"Camí Santa Margarita"					
"Camino del Sindicato"	"Camí del Sindicato"					
"Camino Azanuy de Fonz"	"Camí Azanuy de Fonz"					
"Camino a Alins de Fonz"	"Camí a Alins de Fonz"					
"Camino de Carrodilla a Ardós"	"Camí de Carrodilla a Ardós"					
"camino Cueva de los Moros"	"camí Cueva de los Moros"					
"camino a Calasanz de Azanuy"	"camí a Calasanz de Azanuy"					
"Camino de los Viñedos"	"Camí de los Viñedos"					
"camino del Vilet"	"camí del Vilet"					
"camino ermita San Millán"	"camí ermita San Millán"					
"Camino de Berguelli"	"Camí de Berguelli"					
"camino de Alins"	"camí de Alins"					
"camino antiguo Calasanz a Estadilla"	"camí antiguo Calasanz a Estadilla"					
"Camino de los Cieguez"	"Camí de los Cieguez"					
"camino del Rotizno"	"camí del Rotizno"					
"Camino a Mas de Chias"	"Camí a Mas de Chias"					
"Camino Natural del Sifón de Albelda"	"Camí Natural del Sifón de Albelda"					
"Camino Pequeño"	"Camí Pequeño"					
"Camino de Cardiel a Fraga"	"Camí de Cardiel a Fraga"					
"Camino Della Segre"	"Camí Della Segre"					
"Camino G"	"Camí G"					
"Camino Molino"	"Camí Molino"					
"Camino Ah"	"Camí Ah"					
"Camino Riverola"	"Camí Riverola"					
"Camino Hondos"	"Camí Hondos"					
"Camino Aa"	"Camí Aa"					
"Camino Ae"	"Camí Ae"					
"Camino de la Concepción"	"Camí de la Concepción"					
"Camino Ad"	"Camí Ad"					
"Camino Sotet"	"Camí Sotet"					
"Camino Partida La Ventosa"	"Camí Partida La Ventosa"					
"Camino La Concepción"	"Camí La Concepción"					
"Camino Magdalena, Ag. Miralso"	"Camí Magdalena, Ag. Miralso"					
"Camino Ompriu, Ag. Miralsot"	"Camí Ompriu, Ag. Miralsot"					
"Camino Calanda"	"Camí Calanda"					
"Camino Cabrero"	"Camí Cabrero"					
"Camino Viñas"	"Camí Viñas"					
"Camino Costeretas"	"Camí Costeretas"					
"Camino Codoñera"	"Camí Codoñera"					
"Camino de la Ermita"	"Camí de la Ermita"					
"Camino del Campo de Fútbol"	"Camí del Campo de Fútbol"					
"caminos al rio algars"	"caminos al rio algars"					
"camino del toll de carrasco"	"camí del toll de carrasco"					
"camino vall d´encuadret (jacobeo)"	"camí vall d´encuadret (jacobeo)"					
"camino a piñeres"	"camí a piñeres"					
"camino"	"camino"					
"Camino Piñera"	"Camí Piñera"					
"Camino A"	"Camí A"					
"camino de la venta"	"camí de la venta"					
"Camino Ermita San Jorge"	"Camí Ermita San Jorge"					
"Camino a la Ermita del Pilar"	"Camí a la Ermita del Pilar"					
"Camino del Faro"	"Camí del Faro"					
"Caminos UIB"	"Caminos UIB"					
"Camino de Puig Xacons"	"Camí de Puig Xacons"					
"Camino de Ca'n Turmentat"	"Camí de Ca'n Turmentat"					
"Camino de Cornellar de Can Font"	"Camí de Cornellar de Can Font"					
"Camino de La Porrassa"	"Camí de La Porrassa"					
"Camino de Bòquer"	"Camí de Bòquer"					
"Camino de Cala Jondal"	"Camí de Cala Jondal"					
"Camino principal Can Murtera"	"Camí principal Can Murtera"					
"Camino de Xamena"	"Camí de Xamena"					
"camino cala en Turqueta"	"camí cala en Turqueta"					
"camino cala Macarella"	"camí cala Macarella"					
"Camino de Algaiarens"	"Camí de Algaiarens"					
"camino de Algaraiens"	"camí de Algaraiens"					
"Camino de Sa Torre"	"Camí de Sa Torre"					
"Camino de San Antonio de Ruma"	"Camí de San Antonio de Ruma"					
"Camino de Alots"	"Camí de Alots"					
"Camino de Son Ermita"	"Camí de Son Ermita"					
"Camino de sa Torrol-Lera"	"Camí de sa Torrol-Lera"					
"Camino del Varadero Coves Noves"	"Camí del Varadero Coves Noves"					
"Camino de Sa Cala"	"Camí de Sa Cala"					
"Camino des Codol Foradat"	"Camí des Codol Foradat"					
"Camino Walter Benjamin"	"Camí Walter Benjamin"					
"Camino privado"	"Camí privado"					
"Camino del mirador del torrent"	"Camí del mirador del torrent"					
"Camino de Sant Marçal"	"Camí de Sant Marçal"					
"Camino de uso privado de la finca"	"Camí de uso privado de la finca"					
"Camino  privado finca"	"Camí  privado finca"					
"Camino privado - Prohibido el paso"	"Camí privado - Prohibido el paso"					
"Camino al Bienestar"	"Camí al Bienestar"					
"Camino prohibido. Cercado con vallas."	"Camí prohibido. Cercado con vallas."					
"Camino de cap a camino del rio"	"Camí de cap a camí del rio"					
"Camino casi cerrado en el Torrente por falta de limpieza"	"Camí casi cerrado en el Torrente por falta de limpieza"					
"Camino sin salida"	"Camí sin salida"					
"camino cerrado"	"camí cerrado"					
"Camino de Santiago"	"Camí de Santiago"					
"Camino acceso a Marinada"	"Camí acceso a Marinada"					
"Camino de Palau"	"Camí de Palau"					
"Camino Montesalbo"	"Camí Montesalbo"					
"Camino Ferraes"	"Camí Ferraes"					
"Camino Regatell"	"Camí Regatell"					
"Camino Real"	"Camí Real"					
"Camino Viejo de Castellón"	"Camí Viejo de Castellón"					
"camino del Espigolar"	"camí del Espigolar"					
"Camino Ermita de San Vicente"	"Camí Ermita de San Vicente"					
"Camino del Maset"	"Camí del Maset"					
"Camino a Chodos"	"Camí a Chodos"					
"Camino de San Juan de Peñagolosa"	"Camí de San Juan de Peñagolosa"					
"Camino del Castillo"	"Camí del Castillo"					
"Camino Carmen"	"Camí Carmen"					
"Camino del Mas de Boiro"	"Camí del Mas de Boiro"					
"Camino de La Iglesuela del Cid a Benasal"	"Camí de La Iglesuela del Cid a Benasal"					
"Camino Nevera"	"Camí Nevera"					
"Camino de San Cristóbal"	"Camí de San Cristóbal"					
"Camino de Collet"	"Camí de Collet"					
"Camino Calvario"	"Camí Calvario"					
"Caminos del Señorío de Vilar de Canes"	"Caminos del Señorío de Vilar de Canes"					
"Camino de l'Estany"	"Camí de l'Estany"					
"Camino Casa Pura"	"Camí Casa Pura"					
"Camino del Canaret"	"Camí del Canaret"					
"Camino de l'Atall"	"Camí de l'Atall"					
"Camino del Malentivet"	"Camí del Malentivet"					
"Camino de la Cueva"	"Camí de la Cueva"					
"Camino Azagador de Santa Bárbara"	"Camí Azagador de Santa Bárbara"					
"Camino Corta"	"Camí Corta"					
"Camino del Palmeral"	"Camí del Palmeral"					
"Camino Fondo"	"Camí Fondo"					
"Camino Ermita del Rocío"	"Camí Ermita del Rocío"					
"Camino de San Gregorio"	"Camí de San Gregorio"					
"Camino de la Volta"	"Camí de la Volta"					
"Camino Carmen Volta"	"Camí Carmen Volta"					
"Camino de la Ratlla"	"Camí de la Ratlla"					
"Camino de la Basseta"	"Camí de la Basseta"					
"Camino de Cervera"	"Camí de Cervera"					
"Camino a Peniscola"	"Camí a Peniscola"					
"Camino Viejo Vinaroz"	"Camí Viejo Vinaroz"					
"Camino de los Labradores"	"Camí de los Labradores"					
"Camino de los Planos"	"Camí de los Planos"					
"Camino Ulldecona"	"Camí Ulldecona"					
"Camino Serradal esquina Manuel de Falla"	"Camí Serradal esquina Manuel de Falla"	""	""			
"Camino del Mar"	"Camí del Mar"	""	""			
"Camino de Vilamoncarro"	"Camí de Vilamoncarro"	""	""			
"Camino de Borriol"	"Camí de Borriol"	""	""			
"Camino de la Perrera"	"Camí de la Perrera"	""	""			
"Camino de la Cazuela a San Jaime"	"Camí de la Cazuela a San Jaime"	""	""			
"Camino de los Molinos"	"Camí de los Molinos"	""	""			
"Camino de la Unión"	"Camí de la Unión"	""	""			
"Camino de la Acequia"	"Camí de la Acequia"	""	""			
"Camino Pozo Progreso"	"Camí Pozo Progreso"	""	""			
"Camino Fadrell"	"Camí Fadrell"	""	""			
"Camino Pi Gros"	"Camí Pi Gros"	""	""			
"Camino San Bernardo"	"Camí San Bernardo"	""	""			
"Camino Almalafa"	"Camí Almalafa"	""	""			
"Camino Villamargo"	"Camí Villamargo"	""	""			
"Camino des Clots"	"Camí des Clots"	""	""			
"Camino de Collantes"	"Camí de Collantes"	"Calle San Juan"	"Calle San Juan"			
"Camino de los Barros"	"Camí de los Barros"	""	""			
"Camino del Fondo"	"Camí del Fondo"	""	""			
"Camino de Collantes"	"Camí de Collantes"	""	""			
"Camino Caminàs"	"Camí Caminàs"	""	""			
"Camino de Tornos"	"Camí de Tornos"	""	""			
"Camino Donación"	"Camí Donación"	""	""			
"Camino Borrasa"	"Camí Borrasa"	""	""			
"Camino de Vinatxell"	"Camí de Vinatxell"	""	""			
"Camino Mercader"	"Camí Mercader"	""	""			
"Camino las Delicias"	"Camí las Delicias"	""	""			
"Camino La Ralla Almazora"	"Camí La Ralla Almazora"	""	""			
"Camino de Ramonet"	"Camí de Ramonet"	""	""			
"Camino del Pla de Museros"	"Camí del Pla de Museros"	""	""			
"Camino de la Cuadra del Doñana"	"Camí de la Cuadra del Doñana"	""	""			
"Camino de la Cuadra de Giner"	"Camí de la Cuadra de Giner"	""	""			
"Camino de la Cuadra del Catalán"	"Camí de la Cuadra del Catalán"	""	""			
"Camino del Sequier"	"Camí del Sequier"	""	""			
"Camino Pequeño"	"Camí Pequeño"	""	""			
"Camino de Martí"	"Camí de Martí"	""	""			
"Camino Malvestit"	"Camí Malvestit"	""	""			
"Camino de la Cuadra de Busquets"	"Camí de la Cuadra de Busquets"	""	""			
"Camino del Francés"	"Camí del Francés"	""	""			
"Camino Real de Cova del Colom"	"Camí Real de Cova del Colom"	""	""			
"Camino Cuadra Morteras"	"Camí Cuadra Morteras"	""	""			
"Camino San Jaime"	"Camí San Jaime"	""	""			
"Camino Cuadra Natora"	"Camí Cuadra Natora"	""	""			
"Camino de la Cuadra de Ros"	"Camí de la Cuadra de Ros"	"Cuadra del Coll de Ferro"	"Cuadra del Coll de Ferro"			
"Camino de la Cuadra de Ros"	"Camí de la Cuadra de Ros"	""	""			
"Camino de la Cuadra de la Breva"	"Camí de la Cuadra de la Breva"	""	""			
"Camino de la Cuadra de Portolés"	"Camí de la Cuadra de Portolés"	""	""			
"Camino Cuadra La Torta"	"Camí Cuadra La Torta"	""	""			
"Camino Ribesalbes"	"Camí Ribesalbes"	""	""			
"Camino Cuadra Casaña"	"Camí Cuadra Casaña"	""	""			
"Camino Cuadra Saboner"	"Camí Cuadra Saboner"	""	""			
"Camino Cuadra los Cubos"	"Camí Cuadra los Cubos"	""	""			
"Camino nuevo Cuadra Saboner"	"Camí nuevo Cuadra Saboner"	""	""			
"Camino Cuadra La Salera"	"Camí Cuadra La Salera"	""	""			
"Camino Viejo Alcora"	"Camí Viejo Alcora"	""	""			
"Camino del Molló"	"Camí del Molló"	""	""			
"Camino Collet"	"Camí Collet"	""	""			
"Camino Cuadra Cuarta"	"Camí Cuadra Cuarta"	""	""			
"Camino Cuadra Borriolench"	"Camí Cuadra Borriolench"	""	""			
"Camino Cuadra Tercera"	"Camí Cuadra Tercera"	""	""			
"Camino del Pacífico"	"Camí del Pacífico"	""	""			
"Camino Mota Río Derecha"	"Camí Mota Río Derecha"	""	""			
"Camino La Mota"	"Camí La Mota"	""	""			
"Camino Viejo del Mar"	"Camí Viejo del Mar"	""	""			
"Camino Azorita"	"Camí Azorita"	""	""			
"Camino Cuadra Colomera"	"Camí Cuadra Colomera"	""	""			
"Camino Rural Cuartel"	"Camí Rural Cuartel"	""	""			
"Camino de la Plana"	"Camí de la Plana"	""	""			
"Camino Penyeta Roja"	"Camí Penyeta Roja"	""	""			
"Camino La Mina"	"Camí La Mina"	""	""			
"Camino Romeral"	"Camí Romeral"	""	""			
"Camino de En Riera"	"Camí de En Riera"	""	""			
"Camino Travessera Taxida"	"Camí Travessera Taxida"	""	""			
"Camino del Galeón"	"Camí del Galeón"	""	""			
"Camino de la Huerta"	"Camí de la Huerta"	""	""			
"Camino Almadraba"	"Camí Almadraba"	""	""			
"Camino de l'Infernet"	"Camí de l'Infernet"	""	""			
"Camino de la Sierra de Borriol"	"Camí de la Sierra de Borriol"	""	""			
"Camino de la Coma"	"Camí de la Coma"	""	""			
"Camino de la Serra"	"Camí de la Serra"	""	""			
"Camino Rural La Coma"	"Camí Rural La Coma"	""	""			
"Camino de Borriol a San Juan de Moró"	"Camí de Borriol a San Juan de Moró"	""	""			
"Camino de las Ermitas"	"Camí de las Ermitas"	""	""			
"Camino del Mas de la Figuera"	"Camí del Mas de la Figuera"	""	""			
"Camino Viejo de Barcelona"	"Camí Viejo de Barcelona"	""	""			
"Camino del Racó de Mes"	"Camí del Racó de Mes"	""	""			
"Camino de Codina"	"Camí de Codina"	""	""			
"Camino de la Balaguera"	"Camí de la Balaguera"	""	""			
"Camino del Mas més alt"	"Camí del Mas més alt"	""	""			
"Camino de los Romanos (Vía Augusta)"	"Camí de los Romanos (Vía Augusta)"	""	""			
"Camino del Pou al Naber"	"Camí del Pou al Naber"	""	""			
"Camino de la Baseta a Vall d'Alba"	"Camí de la Baseta a Vall d'Alba"	""	""			
"Camino Pelejana"	"Camí Pelejana"	""	""			
"Camino Serrallo"	"Camí Serrallo"	""	""			
"Camino del Serradal"	"Camí del Serradal"	""	""			
"Camino de la Parra"	"Camí de la Parra"	""	""			
"Camino Bougainvillea"	"Camí Bougainvillea"	""	""			
"Camino Sequia"	"Camí Sequia"	""	""			
"Camino Cobtado"	"Camí Cobtado"	""	""			
"Camino Primera Travesera Fileta"	"Camí Primera Travesera Fileta"	""	""			
"Camino El Tancat"	"Camí El Tancat"	""	""			
"Camino La Unión"	"Camí La Unión"	""	""			
"Camino Viejo del Serradal"	"Camí Viejo del Serradal"	""	""			
"Camino de la Fileta"	"Camí de la Fileta"	""	""			
"Camino Mota"	"Camí Mota"	""	""			
"Camino Font de la Salut"	"Camí Font de la Salut"	""	""			
"Camino Arrozal"	"Camí Arrozal"	""	""			
"Camino Fileta Piquers"	"Camí Fileta Piquers"	""	""			
"Camino del Pou de la Brunella"	"Camí del Pou de la Brunella"	""	""			
"Camino Molins"	"Camí Molins"	""	""			
"Camino Brosser"	"Camí Brosser"	""	""			
"Camino Pozo Sol del Riu"	"Camí Pozo Sol del Riu"	""	""			
"Camino Obra"	"Camí Obra"	""	""			
"Camino Primer Canal"	"Camí Primer Canal"	""	""			
"Camino Motor Serradal"	"Camí Motor Serradal"	""	""			
"Camino de la Carrera"	"Camí de la Carrera"	""	""			
"Camino Marqués"	"Camí Marqués"	""	""			
"Camino del Frontón"	"Camí del Frontón"	""	""			
"Camino Pallars"	"Camí Pallars"	""	""			
"Camino de La Ratlla"	"Camí de La Ratlla"	""	""			
"Camino del Desierto"	"Camí del Desierto"	""	""			
"Camino del Forat"	"Camí del Forat"	""	""			
"Camino Sin Salida"	"Camí Sin Salida"	""	""			
"Camino del Coll de la Mola"	"Camí del Coll de la Mola"	""	""			
"Camino Cassut"	"Camí Cassut"	""	""			
"Camino Viejo de Cabanes"	"Camí Viejo de Cabanes"	""	""			
"Camino de la Cueva"	"Camí de la Cueva"	""	""			
"Camino Trajiners"	"Camí Trajiners"	""	""			
"Camino de la Carretera Vieja"	"Camí de la Carretera Vieja"	""	""			
"Camino de l'Atall"	"Camí de l'Atall"	""	""			
"Camino perimetral"	"Camí perimetral"	""	""			
"Camino de Terreros"	"Camí de Terreros"	""	""			
"Camino de la Font Parralets"	"Camí de la Font Parralets"	""	""			
"Camino de la Marquesa"	"Camí de la Marquesa"	""	""			
"Camino del Puente Viejo"	"Camí del Puente Viejo"	""	""			
"Camino de la Torre"	"Camí de la Torre"	""	""			
"Camino de San José"	"Camí de San José"	""	""			
"Camino de las Turbas"	"Camí de las Turbas"	""	""			
"Camino de los Romanos"	"Camí de los Romanos"	""	""			
"Camino viejo del Mar"	"Camí viejo del Mar"	""	""			
"Camino de Villanueva"	"Camí de Villanueva"	""	""			
"Camino del Raspal"	"Camí del Raspal"	""	""			
"Camino de la Cuesta"	"Camí de la Cuesta"	""	""			
"Camino del Cementerio"	"Camí del Cementerio"	""	""			
"Camino del Molino de Viento"	"Camí del Molino de Viento"	""	""			
"Camino de las Meloneras"	"Camí de las Meloneras"	""	""			
"Camino de Cerdera"	"Camí de Cerdera"	""	""			
"Camino del Bordar"	"Camí del Bordar"	""	""			
"Camino nuevo del Carmen"	"Camí nuevo del Carmen"	""	""			
"Camino de Terra Campa"	"Camí de Terra Campa"					
"Camino de Les Pujades Blanques"	"Camí de Les Pujades Blanques"					
"Camino del Pla del Llobet"	"Camí del Pla del Llobet"					
"Camino viejo de Segorbe"	"Camí viejo de Segorbe"					
"Camino de los Pescadores"	"Camí de los Pescadores"					
"Camino del Calderero"	"Camí del Calderero"					
"Camino Garrut"	"Camí Garrut"					
"Camino Bovalar"	"Camí Bovalar"					
"Camino Fontanals"	"Camí Fontanals"					
"Camino de Beniesma"	"Camí de Beniesma"					
"Camino Serratelles"	"Camí Serratelles"					
"Camino de la Serratella"	"Camí de la Serratella"					
"Camino nuevo del Mar"	"Camí nuevo del Mar"					
"Camino del Mar"	"Camí del Mar"					
"Camino Nuevo"	"Camí Nuevo"					
"Camino La Pedrera"	"Camí La Pedrera"					
"Camino de Alcudia"	"Camí de Alcudia"					
"Camino de La Brassa"	"Camí de La Brassa"					
"Camino Serratella"	"Camí Serratella"					
"Camino Pedralba"	"Camí Pedralba"					
"Camino de la Huerta Seca"	"Camí de la Huerta Seca"					
"Camino Cementerio"	"Camí Cementerio"					
"Camino del Arquet"	"Camí del Arquet"					
"Camino viejo del Carmen"	"Camí viejo del Carmen"					
"Camino Miralcamp"	"Camí Miralcamp"					
"Camino Capamantos"	"Camí Capamantos"					
"Camino del Convento"	"Camí del Convento"					
"Camino de Betxí"	"Camí de Betxí"					
"Camino del Aguillador"	"Camí del Aguillador"					
"Camino Colador"	"Camí Colador"					
"Camino de Ratils"	"Camí de Ratils"					
"Camino Viejo de Onda a Castellón"	"Camí Viejo de Onda a Castellón"					
"Camino Lloma de Miralcamp"	"Camí Lloma de Miralcamp"					
"Camino Corral de Diago"	"Camí Corral de Diago"					
"Camino de Palos"	"Camí de Palos"					
"Camino la Rambla"	"Camí la Rambla"					
"Camino del Toll"	"Camí del Toll"					
"Camino de les Trencaes"	"Camí de les Trencaes"					
"Camino del Collado"	"Camí del Collado"					
"Camino del Pas de la Fulla"	"Camí del Pas de la Fulla"					
"Camino del Margen de Llombai"	"Camí del Margen de Llombai"					
"Camino del Caminàs"	"Camí del Caminàs"					
"Camino deVila-real"	"Camí deVila-real"					
"Camino del Apeadero"	"Camí del Apeadero"					
"Camino de Vila-real"	"Camí de Vila-real"					
"Camino Apeadero Miralcamp"	"Camí Apeadero Miralcamp"					
"Camino Corral de Diego"	"Camí Corral de Diego"					
"Camino Bellot"	"Camí Bellot"					
"Camino Carinyena"	"Camí Carinyena"					
"Camino les Voltes"	"Camí les Voltes"					
"Camino de Artana Vila-Real"	"Camí de Artana Vila-Real"					
"Camino Torrehermosa"	"Camí Torrehermosa"					
"Camino Azagador"	"Camí Azagador"					
"Camino viejo Onda - Castellón"	"Camí viejo Onda - Castellón"					
"Camino de les Monges"	"Camí de les Monges"					
"Camino Vell de Llombai"	"Camí Vell de Llombai"					
"Camino Tercer Sedeny"	"Camí Tercer Sedeny"					
"Camino del Molino de la Roqueta"	"Camí del Molino de la Roqueta"					
"Camino de Sedre"	"Camí de Sedre"					
"Camino de la Boneta"	"Camí de la Boneta"					
"Camino de Cantera"	"Camí de Cantera"					
"Camino Hondo"	"Camí Hondo"					
"Camino del Mas de Piñón"	"Camí del Mas de Piñón"					
"Camino de Ramonet"	"Camí de Ramonet"					
"Camino del Garbí CV-3342"	"Camí del Garbí CV-3342"					
"Camino Campo de Futbol"	"Camí Campo de Futbol"					
"Camino del Molino Costa"	"Camí del Molino Costa"					
"Camino de la Barraix a Beselga"	"Camí de la Barraix a Beselga"					
"camino de la Foya"	"camí de la Foya"					
"Camino de los Valles"	"Camí de los Valles"					
"Camino dels Rolls"	"Camí dels Rolls"					
"Camino a los Valles"	"Camí a los Valles"					
"Camino dels Omets"	"Camí dels Omets"					
"Camino de Les Escales"	"Camí de Les Escales"					
"Camino del Caracol"	"Camí del Caracol"					
"Camino del Puig"	"Camí del Puig"					
"Camino de Camarena"	"Camí de Camarena"					
"Camino de la Cantera"	"Camí de la Cantera"					
"Camino de Fondo de Beniferri"	"Camí de Fondo de Beniferri"					
"Camino de Fondo"	"Camí de Fondo"					
"Camino Viejo de Godella"	"Camí Viejo de Godella"					
"Camino Viejo de Valencia"	"Camí Viejo de Valencia"					
"Camino de Godella"	"Camí de Godella"					
"Camino de Vinalesa"	"Camí de Vinalesa"					
"Camino viejo Torrente - Piscina"	"Camí viejo Torrente - Piscina"					
"Camino viejo Torrente, 22"	"Camí viejo Torrente, 22"					
"Camino de los Felipes"	"Camí de los Felipes"					
"Camino de Alcàsser a Torrente"	"Camí de Alcàsser a Torrente"					
"Camino de Alcasser a Paiporta"	"Camí de Alcasser a Paiporta"					
"Camino de Torrente a Benetúser"	"Camí de Torrente a Benetúser"					
"Camino Malpas"	"Camí Malpas"					
"Camino de Torrente"	"Camí de Torrente"					
"Camino del Bobalar"	"Camí del Bobalar"					
"Camino de la Mojonera"	"Camí de la Mojonera"					
"Camino del Mas de Morell"	"Camí del Mas de Morell"					
"Camino del Azagador"	"Camí del Azagador"					
"Camino de los Naranjos"	"Camí de los Naranjos"					
"Camino Viejo de Cheste"	"Camí Viejo de Cheste"					
"Camino de las Traveseras"	"Camí de las Traveseras"					
"Camino del Racholar"	"Camí del Racholar"					
"Camino Nuevo de Paterna"	"Camí Nuevo de Paterna"					
"Camino de Santiago de la Lana de Valencia"	"Camí de Santiago de la Lana de Valencia"					
"Camino Devadillo"	"Camí Devadillo"					
"Camino de Alcàsser a Paiporta"	"Camí de Alcàsser a Paiporta"					
"Camino de la Foya"	"Camí de la Foya"					
"Camino de Catarroja"	"Camí de Catarroja"					
"Camino de Paiporta a Catarroja"	"Camí de Paiporta a Catarroja"					
"Camino del Malpás"	"Camí del Malpás"					
"Camino Real de Madrid"	"Camí Real de Madrid"					
"Camino de la Marjal"	"Camí de la Marjal"					
"Camino Viejo de Silla"	"Camí Viejo de Silla"					
"Camino de Polio"	"Camí de Polio"					
"Camino del Molino Quemado"	"Camí del Molino Quemado"					
"Camino de Castellar"	"Camí de Castellar"					
"Camino de la Mànega"	"Camí de la Mànega"					
"Camino de la Pascualeta"	"Camí de la Pascualeta"					
"Camino de la Cruz de Elena"	"Camí de la Cruz de Elena"					
"Camino Benlloch"	"Camí Benlloch"					
"Camino de la Hermandad"	"Camí de la Hermandad"					
"Camino de la Viña"	"Camí de la Viña"					
"Camino de Santiago de Levante"	"Camí de Santiago de Levante"					
"Camino de Carrabera"	"Camí de Carrabera"					
"Camino del Llano del Rey"	"Camí del Llano del Rey"					
"Camino de Fuente la Higuera"	"Camí de Fuente la Higuera"					
"Camino sin nombre"	"Camí sin nombre"					
"Camino Fuente Quintana"	"Camí Fuente Quintana"					
"Camino Hoyas"	"Camí Hoyas"					
"Camino Quintana"	"Camí Quintana"					
"Camino Portet"	"Camí Portet"					
"Camino del Ros"	"Camí del Ros"					
"Camino Corral de Mateu"	"Camí Corral de Mateu"					
"Camino Altet de Molina"	"Camí Altet de Molina"					
"Camino Belén"	"Camí Belén"					
"Camino Mateu Cuadrado"	"Camí Mateu Cuadrado"					
"Camino Fillola"	"Camí Fillola"					
"Camino Castillo"	"Camí Castillo"					
"Camino Telefónica"	"Camí Telefónica"					
"Camino Vallfart"	"Camí Vallfart"					
"Camino a Manuel"	"Camí a Manuel"					
"Camino del Alba"	"Camí del Alba"					
"Camino el Molí del Riu"	"Camí el Molí del Riu"					
"Camino de las vacas"	"Camí de las vacas"					
"Camino de la Raconada"	"Camí de la Raconada"					
"Camino"	"Camino"					
"Camino de la Partideta"	"Camí de la Partideta"					
"Camino de la Rápita"	"Camí de la Rápita"					
"Camino Estell"	"Camí Estell"					
"Camino del Rio"	"Camí del Rio"					
"Camino Pouet"	"Camí Pouet"					
"Camino Llosar"	"Camí Llosar"					
"Camino de Antiguo Ferrocarril"	"Camí de Antiguo Ferrocarril"					
"Camino viejo de Gandia"	"Camí viejo de Gandia"					
"Camino Torre dels Pares"	"Camí Torre dels Pares"					
"Camino del Moli de Vent"	"Camí del Moli de Vent"					
"Camino cementerio"	"Camí cementerio"					
"Camino Miramar"	"Camí Miramar"					
"Camino Natural de l'Antic Trenet"	"Camí Natural de l'Antic Trenet"					
"Camino de Caminás"	"Camí de Caminás"					
"Camino a Ponce"	"Camí a Ponce"					
"Camino del Torrater (tramo cementerio)"	"Camí del Torrater (tramo cementerio)"					
"Camino Torrater- Font del Pate - Cova Alta"	"Camí Torrater- Font del Pate - Cova Alta"					
"Caminoa Agres"	"Caminoa Agres"					
"Camino Ermita Sant Esteve"	"Camí Ermita Sant Esteve"					
"Camino de Bonavista"	"Camí de Bonavista"					
"Camino de la Purisima"	"Camí de la Purisima"					
"Camino Font del Patge"	"Camí Font del Patge"					
"Camino Cercavilla"	"Camí Cercavilla"					
"Camino Llibertat"	"Camí Llibertat"					
"Camino Gandia"	"Camí Gandia"					
"camino del club de tenis"	"camí del club de tenis"					
"Camino Almacera"	"Camí Almacera"					
"Camino Ràfol"	"Camí Ràfol"					
"Camino Lluchente"	"Camí Lluchente"					
"Camino Alonsos"	"Camí Alonsos"					
"Camino Sendeta"	"Camí Sendeta"					
"Camino Quadreondeta"	"Camí Quadreondeta"					
"Camino de Ronda - Piscinas Municipales"	"Camí de Ronda - Piscinas Municipales"	""	""			
"Camino Fondo de Piqueres, 13"	"Camí Fondo de Piqueres, 13"	""	""			
"Camino Baiona - Policia Local"	"Camí Baiona - Policia Local"	""	""			
"Camino Baiona - Cm. Vecinal"	"Camí Baiona - Cm. Vecinal"	""	""			
"Camino del Mahones - La Casta"	"Camí del Mahones - La Casta"	""	""			
"Camino del Mahones - Juncaret"	"Camí del Mahones - Juncaret"	""	""			
"Camino Baiona - La Palmera"	"Camí Baiona - La Palmera"	""	""			
"Camino Del Faro, 25"	"Camí Del Faro, 25"	""	""			
"Camino Del Faro, 17"	"Camí Del Faro, 17"	""	""			
"Camino Del Faro, 37"	"Camí Del Faro, 37"	""	""			
"camino de la Cueva de San Pascual"	"camí de la Cueva de San Pascual"	""	""			
"camino Celler"	"camí Celler"	""	""			
"camino de la Altura"	"camí de la Altura"	""	""			
"camino del Puig"	"camí del Puig"	""	""			
"camino Viejo de Saladas"	"camí Viejo de Saladas"	""	""			
"camino Colina Blanda"	"camí Colina Blanda"	""	""			
"camino Ladera Real"	"camí Ladera Real"	""	""			
"camino Alto Verde"	"camí Alto Verde"	""	""			
"camino del Monte Alto"	"camí del Monte Alto"	""	""			
"camino de Miranda"	"camí de Miranda"	""	""			
"camino del Trópico"	"camí del Trópico"	""	""			
"camino de la Platanera"	"camí de la Platanera"	""	""			
"camino de El Fraile"	"camí de El Fraile"	""	""			
"camino de Chaleta a Alicante"	"camí de Chaleta a Alicante"	""	""			
"camino de lo Sala"	"camí de lo Sala"	""	""			
"camino de Palomares"	"camí de Palomares"	""	""			
"camino de lo Verdú"	"camí de lo Verdú"	""	""			
"camino de La Alcoraya"	"camí de La Alcoraya"	""	""			
"camino de la Iglesia"	"camí de la Iglesia"	""	""			
"camino Lomas Blancas"	"camí Lomas Blancas"	""	""			
"camino de La Galera"	"camí de La Galera"	""	""			
"camino Ballestera"	"camí Ballestera"	""	""			
"camino La Galera"	"camí La Galera"	""	""			
"camino de Los Pinos"	"camí de Los Pinos"	""	""			
"camino de Los Naranjos"	"camí de Los Naranjos"	""	""			
"camino de Los Olivos"	"camí de Los Olivos"	""	""			
"camino del Algarrobo"	"camí del Algarrobo"	""	""			
"camino Lo Lucas"	"camí Lo Lucas"	""	""			
"camino de La Fiesta"	"camí de La Fiesta"	""	""			
"Camino del Palmito"	"Camí del Palmito"	""	""			
"camino del Herrero"	"camí del Herrero"	""	""			
"camino de la Urraca"	"camí de la Urraca"	""	""			
"camino de la Cacatúa"	"camí de la Cacatúa"	""	""			
"camino del Gavilán"	"camí del Gavilán"	""	""			
"camino de Ibis"	"camí de Ibis"	""	""			
"camino Quetzal"	"camí Quetzal"	""	""			
"camino de la Sierra de los Leones"	"camí de la Sierra de los Leones"	""	""			
"camino del Carnero"	"camí del Carnero"	""	""			
"camino del Moncayo"	"camí del Moncayo"	""	""			
"camino del Teide"	"camí del Teide"	""	""			
"camino de la Gardenia"	"camí de la Gardenia"	""	""			
"camino de la Violeta"	"camí de la Violeta"	""	""			
"Camino de la Alcoraya"	"Camí de la Alcoraya"	""	""			
"camino a La Serrella"	"camí a La Serrella"	""	""			
"camino de la Mina"	"camí de la Mina"	""	""			
"Camino de Aquiles"	"Camí de Aquiles"	""	""			
"camino Piqueres"	"camí Piqueres"	""	""			
"camino del Naranjo de Bulnes"	"camí del Naranjo de Bulnes"	""	""			
"camino de Manchegos"	"camí de Manchegos"	""	""			
"Camino de Pepe Campaneta"	"Camí de Pepe Campaneta"	""	""			
"camino Argentino"	"camí Argentino"	""	""			
"camino Galena"	"camí Galena"	""	""			
"camino Berilio"	"camí Berilio"	""	""			
"camino Pirita"	"camí Pirita"	""	""			
"camino de La Colomina"	"camí de La Colomina"	""	""			
"camino de la Casa Roja"	"camí de la Casa Roja"	""	""			
"Camino de Borja"	"Camí de Borja"	""	""			
"camino de la Alcoraya"	"camí de la Alcoraya"	""	""			
"camino Fondo Piqueras"	"camí Fondo Piqueras"	""	""			
"camino a la galería de tiro"	"camí a la galería de tiro"	""	""			
"camino del fondo Piqueres"	"camí del fondo Piqueres"	""	""			
"Camino Viejo de la Santa Faz"	"Camí Viejo de la Santa Faz"	""	""			
"camino de la colonia romana"	"camí de la colonia romana"	""	""			
"camino viejo de San Juan"	"camí viejo de San Juan"	""	""			
"camino de Benimagrell"	"camí de Benimagrell"	""	""			
"camino de la costa"	"camí de la costa"	""	""			
"Camino de Rumella"	"Camí de Rumella"	""	""			
"camino del ciprés"	"camí del ciprés"	""	""			
"Camino de la Cruz de la Piedra"	"Camí de la Cruz de la Piedra"	""	""			
"camino de Novelda a San Vicente"	"camí de Novelda a San Vicente"	""	""			
"camino de Elche a Agost"	"camí de Elche a Agost"	""	""			
"Camino de la Murta"	"Camí de la Murta"	""	""			
"Camino Barranco Tío Isidoro"	"Camí Barranco Tío Isidoro"	""	""			
"camino del Verdegás"	"camí del Verdegás"	""	""			
"camino de la Ermita del Moralet"	"camí de la Ermita del Moralet"	""	""			
"camino de Las Lomas"	"camí de Las Lomas"	""	""			
"camino del Cuartel"	"camí del Cuartel"	""	""			
"camino Viejo de Alicante"	"camí Viejo de Alicante"	""	""			
"camino de La Estación"	"camí de La Estación"	""	""			
"camino de la Yesera"	"camí de la Yesera"	""	""			
"camino de Monforte a San Vicente"	"camí de Monforte a San Vicente"	""	""			
"camino Rio Mundo"	"camí Rio Mundo"	""	""			
"camino Rio Guadiana"	"camí Rio Guadiana"	""	""			
"camino Rio Guadalquivir"	"camí Rio Guadalquivir"	""	""			
"camino Rio Mijares"	"camí Rio Mijares"	""	""			
"camino de La Molineta"	"camí de La Molineta"	""	""			
"camino de la Almazara"	"camí de la Almazara"	""	""			
"camino del Parral"	"camí del Parral"	""	""			
"camino al Rambuchar"	"camí al Rambuchar"	""	""			
"camino del Paso a Nivel"	"camí del Paso a Nivel"	""	""			
"camino Los Ferrándiz"	"camí Los Ferrándiz"	""	""			
"camino de las Nieves"	"camí de las Nieves"	""	""			
"camino del Boronat"	"camí del Boronat"	""	""			
"camino de Fenoll"	"camí de Fenoll"	""	""			
"camino Casa Don Jaime"	"camí Casa Don Jaime"	""	""			
"camino de Huesca"	"camí de Huesca"	""	""			
"camino del Pantanet"	"camí del Pantanet"	""	""			
"camino Alto de los Leones"	"camí Alto de los Leones"	""	""			
"Camino del Palamó a Peñaroya"	"Camí del Palamó a Peñaroya"	""	""			
"Camino del Sabinar"	"Camí del Sabinar"	""	""			
"camino del Rincon Lomas del Sabinar"	"camí del Rincon Lomas del Sabinar"	""	""			
"camino Vereda de los Pescadores"	"camí Vereda de los Pescadores"	""	""			
"camino de Berenguer"	"camí de Berenguer"	""	""			
"camino de la Bayona"	"camí de la Bayona"	""	""			
"camino de la Providencia"	"camí de la Providencia"	""	""			
"camino Paraje Alcaraz"	"camí Paraje Alcaraz"	""	""			
"Camino del Hielo"	"Camí del Hielo"	""	""			
"camino de la Bayona Alta"	"camí de la Bayona Alta"	""	""			
"camino Huerto de Reynera"	"camí Huerto de Reynera"	""	""			
"camino del cementerio"	"camí del cementerio"	""	""			
"Camino Viejo de Tángel"	"Camí Viejo de Tángel"	""	""			
"camino del Serení"	"camí del Serení"	""	""			
"Camino de los Frailes"	"Camí de los Frailes"	""	""			
"Camino de la Alquería"	"Camí de la Alquería"	""	""			
"Camino de Lampa"	"Camí de Lampa"	""	""			
"Camino de Carreres"	"Camí de Carreres"	""	""			
"Camino Viejo de Aigües"	"Camí Viejo de Aigües"	""	""			
"Camino de la Prensa"	"Camí de la Prensa"	""	""			
"Camino El de Gorman"	"Camí El de Gorman"	""	""			
"Camino del Cantalar"	"Camí del Cantalar"	""	""			
"camino del Pantano"	"camí del Pantano"	""	""			
"Camino de Vivens"	"Camí de Vivens"	""	""			
"Camino del Faro"	"Camí del Faro"	""	""			
"camino Lope de Vega"	"camí Lope de Vega"	""	""			
"camino de la Vila Joiosa"	"camí de la Vila Joiosa"	""	""			
"camino de la Bajada al Río"	"camí de la Bajada al Río"	""	""			
"Camino del Balneario"	"Camí del Balneario"	""	""			
"Camino de Santiago de la Lana de Alicante"	"Camí de Santiago de la Lana de Alicante"	"Ruta de la Lana"	"Ruta de la Lana"			
"Camino del Sureste - Ramal de Benidorm"	"Camí del Sureste - Ramal de Benidorm"	""	""			
"Camino de Jijona"	"Camí de Jijona"	""	""			
"Camino de los Magros 3"	"Camí de los Magros 3"					
"Camino del Hondo"	"Camí del Hondo"					
"Camino del Convenio Nuevo"	"Camí del Convenio Nuevo"					
"Camino de los Presos"	"Camí de los Presos"					
"Camino de la Escuera"	"Camí de la Escuera"					
"Camino de la Noria"	"Camí de la Noria"					
"Camino de Campanilla"	"Camí de Campanilla"					
"Camino de la Plana"	"Camí de la Plana"					
"Camino Crevillente a la Cuesta de Boix"	"Camí Crevillente a la Cuesta de Boix"					
"Camino Casa Candela a Boix"	"Camí Casa Candela a Boix"					
"Camino de los Cipreses"	"Camí de los Cipreses"					
"Camino de San Cayetano"	"Camí de San Cayetano"					
"camino del barranco de Catral"	"camí del barranco de Catral"					
"Camino de las Fincas"	"Camí de las Fincas"					
"Camino Privado"	"Camí Privado"					
"Camino de Servicio Riegos de Levante"	"Camí de Servicio Riegos de Levante"					
"Camino de la casita de reposo"	"Camí de la casita de reposo"					
"Camino de la emisora"	"Camí de la emisora"					
"Camino de Ríos y Sanmartín"	"Camí de Ríos y Sanmartín"					
"Camino de Gonzálvez y Aubalat"	"Camí de Gonzálvez y Aubalat"					
"camino del cementerio nuevo"	"camí del cementerio nuevo"					
"Camino viejo Elche-Dolores"	"Camí viejo Elche-Dolores"					
"Camino de los Patiños"	"Camí de los Patiños"					
"Camino de Las Bayas"	"Camí de Las Bayas"					
"camino de la casa del ruido"	"camí de la casa del ruido"					
"Camino de Guardamar"	"Camí de Guardamar"					
"camino Viejo de Aspe"	"camí Viejo de Aspe"					
"camino de los Magros"	"camí de los Magros"					
"camino de Ferrández"	"camí de Ferrández"					
"Camino de Castilla"	"Camí de Castilla"					
"Camino de Perleta"	"Camí de Perleta"					
"Camino de la Casa Monfortera"	"Camí de la Casa Monfortera"					
"Camino Viejo de Castilla"	"Camí Viejo de Castilla"					
"Camino de Castila"	"Camí de Castila"					
"Camino Vallongas"	"Camí Vallongas"					
"camino viejo de Alicante"	"camí viejo de Alicante"					
"camino Viejo de Saladas"	"camí Viejo de Saladas"					
"Camino Taibilla"	"Camí Taibilla"					
"camino Colina Blanda"	"camí Colina Blanda"					
"camino de la Platanera"	"camí de la Platanera"					
"camino de Chaleta a Alicante"	"camí de Chaleta a Alicante"					
"Camino del Sureste - Ramal Sur"	"Camí del Sureste - Ramal Sur"					
"Camino Atalaya"	"Camí Atalaya"					
"Camino Subida"	"Camí Subida"					
"Camino tras las Caras"	"Camí tras las Caras"					
"Camino de Sax a Castalla"	"Camí de Sax a Castalla"					
"Camino del Pantano de Tibi"	"Camí del Pantano de Tibi"					
"Camino de Moret de Baix"	"Camí de Moret de Baix"					
"camino Azagador del Llosar"	"camí Azagador del Llosar"					
"camino de la Alcornia"	"camí de la Alcornia"					
"camino de Albabor"	"camí de Albabor"					
"Camino de Vivens"	"Camí de Vivens"					
"Camino La Coveta"	"Camí La Coveta"					
"Camino de Ibi"	"Camí de Ibi"					
"Camino Santa Lucía"	"Camí Santa Lucía"					
"Camino Raya de Castalla"	"Camí Raya de Castalla"					
"Camino Plans"	"Camí Plans"					
"Camino del Llavador"	"Camí del Llavador"					
"Camino de San Miguel"	"Camí de San Miguel"					
"Camino del Sureste - Ramal de Benidorm"	"Camí del Sureste - Ramal de Benidorm"					
"Camino del Carrascar"	"Camí del Carrascar"					
"Camino de Jijona"	"Camí de Jijona"					
"Camino Barranco"	"Camí Barranco"					
"Camino fonteta Pinça"	"Camí fonteta Pinça"					
"Camino Olegario"	"Camí Olegario"					
"Camino Cervera"	"Camí Cervera"					
"Camino Teulada"	"Camí Teulada"					
"Camino Solana Segador"	"Camí Solana Segador"					
"Camino dels Tossals"	"Camí dels Tossals"					
"Camino del Andragó"	"Camí del Andragó"					
"Camino de la Sabatera"	"Camí de la Sabatera"					
"Camino del Paellero"	"Camí del Paellero"					
"Camino del Campamento"	"Camí del Campamento"					
"Camino de la Camarrocha"	"Camí de la Camarrocha"					
"Camino de Benimeit"	"Camí de Benimeit"					
"Camino de la Viuda"	"Camí de la Viuda"					
"Camino Viejo del Portet"	"Camí Viejo del Portet"					
"Camino de la Bassa"	"Camí de la Bassa"					
"Camino de Abiar Alta"	"Camí de Abiar Alta"					
"Camino de El Verger"	"Camí de El Verger"					
"Camino de la Plaza Garrofer"	"Camí de la Plaza Garrofer"					
"Camino Abiar"	"Camí Abiar"					
"Camino Riu Gorgos"	"Camí Riu Gorgos"					
"Camino Frechinal"	"Camí Frechinal"					
"Camino Senia Vella"	"Camí Senia Vella"					
"Camino del Alba - Ramal de Dénia"	"Camí del Alba - Ramal de Dénia"					
"Camino del Paraiso"	"Camí del Paraiso"					
"camino hospital"	"camí hospital"					
"Camino Viejo de Altea"	"Camí Viejo de Altea"					
"Camino Puma"	"Camí Puma"					
"Camino del Sarando"	"Camí del Sarando"					
"Camino de Rotes"	"Camí de Rotes"					
"Camino de la Solana"	"Camí de la Solana"					
"Camino Runar"	"Camí Runar"					
"camino del Algar"	"camí del Algar"					
"Camino del Sureste - Ramal de Villajoyosa"	"Camí del Sureste - Ramal de Villajoyosa"					
"Camino del Cabañal"	"Camí del Cabañal"					
"Camino del Cavalló"	"Camí del Cavalló"					
"Camino del Tremolar"	"Camí del Tremolar"					
"Camino de la Alquería Chirivelleta"	"Camí de la Alquería Chirivelleta"					
"Camino Andarella"	"Camí Andarella"					
"Camino del 14 de Octubre"	"Camí del 14 de Octubre"					
"Camino Viejo de Carpesa a Borbotó"	"Camí Viejo de Carpesa a Borbotó"					
"Camino de Borbotó a Godella"	"Camí de Borbotó a Godella"					
"Camino de la Canal"	"Camí de la Canal"					
"Camino de la Vega dels Llivis"	"Camí de la Vega dels Llivis"					
"Camino de Pedralba a Valencia"	"Camí de Pedralba a Valencia"					
"Camino Chacarell"	"Camí Chacarell"					
"Camino de los Yesares"	"Camí de los Yesares"					
"Camino de la Villalba"	"Camí de la Villalba"					
"Camino de Cheste"	"Camí de Cheste"					
"Camino del Pouet Tapat"	"Camí del Pouet Tapat"					
"Camino de la Bassa Barreta"	"Camí de la Bassa Barreta"					
"Camino de la Cova de Mirapeix"	"Camí de la Cova de Mirapeix"					
"Camino de Carasoles"	"Camí de Carasoles"					
"Camino de Possa"	"Camí de Possa"					
"Camino de Belén"	"Camí de Belén"					
"Camino de Les Plantaes"	"Camí de Les Plantaes"					
"camino del depósito"	"camí del depósito"					
"Camino Mas de la Lloca"	"Camí Mas de la Lloca"					
"Camino Granotera"	"Camí Granotera"					
"Camino de la Creu"	"Camí de la Creu"					
"Camino del Assagador"	"Camí del Assagador"					
"Camino de la Casablanca"	"Camí de la Casablanca"					
"Camino de Bétera"	"Camí de Bétera"					
"Camino del Caramello a la Cañada de Tello"	"Camí del Caramello a la Cañada de Tello"					
"Camino de la Fuente de San Vicente"	"Camí de la Fuente de San Vicente"					
"Camino Viejo de Chelva"	"Camí Viejo de Chelva"					
"Camino Agrícola"	"Camí Agrícola"					
"Camino de los Frailes"	"Camí de los Frailes"					
"Camino del Caramello a la Cañada"	"Camí del Caramello a la Cañada"					
"Camino de la seu"	"Camí de la seu"					
"Camino Charchán"	"Camí Charchán"					
"Camino la Reana"	"Camí la Reana"					
"Camino de Segart"	"Camí de Segart"					
"Camino La Falaguera"	"Camí La Falaguera"					
"Camino de Olla"	"Camí de Olla"					
"Camino de la Balsa Blanca"	"Camí de la Balsa Blanca"					
"Camino de los Burrets"	"Camí de los Burrets"					
"Camino del Cementerio Viejo"	"Camí del Cementerio Viejo"					
"Camino Subida al Parque"	"Camí Subida al Parque"					
"Camino Viejo de Gabarda"	"Camí Viejo de Gabarda"					
"Camino Racó del Poble"	"Camí Racó del Poble"					
"Camino Cerdá"	"Camí Cerdá"					
"Camino de la Vall"	"Camí de la Vall"					
"Camino de Misana"	"Camí de Misana"					
"Camino de Alasquer"	"Camí de Alasquer"					
"Camino entrador"	"Camí entrador"					
"Camino de Villarrubia"	"Camí de Villarrubia"					
"Camino de San Bernardo"	"Camí de San Bernardo"					
"Camino Piscina Canut"	"Camí Piscina Canut"					
"Camino de Vora Riu"	"Camí de Vora Riu"					
"Camino de los Molinos"	"Camí de los Molinos"					
"Camino de Penyes Negres"	"Camí de Penyes Negres"					
"Camino del Corral Blanc"	"Camí del Corral Blanc"					
"Camino de Sax a Castalla"	"Camí de Sax a Castalla"	""	""			
"Camino de Játiva"	"Camí de Játiva"	""	""			
"Camino Barracons"	"Camí Barracons"	""	""			
"Camino Campo de Mirra"	"Camí Campo de Mirra"	""	""			
"Camino del Mesón"	"Camí del Mesón"	""	""			
"camino Barbarroja - La Canalosa"	"camí Barbarroja - La Canalosa"	""	""			
"Camino Cañada Albanilla"	"Camí Cañada Albanilla"	""	""			
"Camino del Agudo"	"Camí del Agudo"	""	""			
"camino de los Serranos"	"camí de los Serranos"	""	""			
"Camino Los Muertos"	"Camí Los Muertos"	""	""			
"Camino de Casas Alto"	"Camí de Casas Alto"	""	""			
"Camino de la Vertiente"	"Camí de la Vertiente"	""	""			
"camino de la cruz"	"camí de la cruz"	""	""			
"Camino Ventanas"	"Camí Ventanas"	""	""			
"Camino Vereda Agudo"	"Camí Vereda Agudo"	""	""			
"camino Casas de Galiana"	"camí Casas de Galiana"	""	""			
"camino Hondón de los Frailes - Canalosa"	"camí Hondón de los Frailes - Canalosa"	""	""			
"Camino Del La Fuente"	"Camí Del La Fuente"	""	""			
"Camino La Ermita"	"Camí La Ermita"	""	""			
"Camino de la Llometa"	"Camí de la Llometa"	""	""			
"Camino de Castilla"	"Camí de Castilla"	""	""			
"Camino de Spans"	"Camí de Spans"	""	""			
"Camino Del Roig"	"Camí Del Roig"	""	""			
"Camino del Olivar"	"Camí del Olivar"	""	""			
"camino la ermita"	"camí la ermita"	""	""			
"Camino de las Piscinas"	"Camí de las Piscinas"	""	""			
"Camino Real/Casas Galianas"	"Camí Real/Casas Galianas"	""	""			
"Camino del Colorado"	"Camí del Colorado"	""	""			
"Camino del Cucurucho"	"Camí del Cucurucho"	""	""			
"camino cementerio"	"camí cementerio"	""	""			
"Camino de los Pinos"	"Camí de los Pinos"	""	""			
"Camino de los Davons"	"Camí de los Davons"	""	""			
"Camino Rincón de Penalva"	"Camí Rincón de Penalva"	""	""			
"Camino Gasolinera"	"Camí Gasolinera"	""	""			
"camino de las Casas de Galiana"	"camí de las Casas de Galiana"	""	""			
"Camino Casas Galiana"	"Camí Casas Galiana"	""	""			
"camino"	"camino"	""	""			
"Camino del Bayón"	"Camí del Bayón"	""	""			
"Camino de la Boquera"	"Camí de la Boquera"	""	""			
"Camino del Altico"	"Camí del Altico"	""	""			
"camino los Polsegeros"	"camí los Polsegeros"	""	""			
"camino de Cieza"	"camí de Cieza"	""	""			
"camino Polseguera"	"camí Polseguera"	""	""			
"camino de los Canicios"	"camí de los Canicios"	""	""			
"camino de Cuevas"	"camí de Cuevas"	""	""			
"camino de los Machos"	"camí de los Machos"	""	""			
"camino de la Mercadera"	"camí de la Mercadera"	""	""			
"Camino secundario"	"Camí secundario"	""	""			
"Camino El Culebrón"	"Camí El Culebrón"	""	""			
"Camino de El Hondón"	"Camí de El Hondón"	""	""			
"Camino Viejo de Yecla"	"Camí Viejo de Yecla"	""	""			
"Camino Ariza"	"Camí Ariza"	""	""			
"Camino de Matamoros"	"Camí de Matamoros"	""	""			
"Camino de Ravalet"	"Camí de Ravalet"	""	""			
"Camino poligono"	"Camí poligono"	""	""			
"camino de la Horna"	"camí de la Horna"	""	""			
"camino Viejo de Hondón"	"camí Viejo de Hondón"	""	""			
"Camino de la Casa Monfortera"	"Camí de la Casa Monfortera"	""	""			
"camino Casa de los Pavos"	"camí Casa de los Pavos"	""	""			
"camino de Aspe a San Pascual"	"camí de Aspe a San Pascual"	""	""			
"Camino de Elche"	"Camí de Elche"	""	""			
"camino del Cucuch"	"camí del Cucuch"	""	""			
"Camino de Aspe a San Pascual (Orito)"	"Camí de Aspe a San Pascual (Orito)"	""	""			
"Camino del Sureste - Ramal Sur"	"Camí del Sureste - Ramal Sur"	""	""			
"Camino del Moncayo"	"Camí del Moncayo"					
"Camino Ermita Vieja"	"Camí Ermita Vieja"					
"Camino Depuradora"	"Camí Depuradora"					
"Camino Viejo de Guardamar"	"Camí Viejo de Guardamar"					
"Camino Los Curros"	"Camí Los Curros"					
"Camino de La Mata"	"Camí de La Mata"					
"Camino de la Casa Blanca"	"Camí de la Casa Blanca"					
"Camino La Serviola"	"Camí La Serviola"					
"Camino de la Rambla"	"Camí de la Rambla"					
"Camino Las Perdigueras"	"Camí Las Perdigueras"					
"Camino Los Claveles"	"Camí Los Claveles"					
"Camino La Torre"	"Camí La Torre"					
"Camino Guardamar Rojales"	"Camí Guardamar Rojales"					
"Camino de Acceso Marjal"	"Camí de Acceso Marjal"					
"camino Barbarroja - La Canalosa"	"camí Barbarroja - La Canalosa"					
"Camino Cañada Albanilla"	"Camí Cañada Albanilla"					
"camino de los Serranos"	"camí de los Serranos"					
"camino de la cruz"	"camí de la cruz"					
