"name"	"name:ca"	"alt_name:ca"	"alt_name"	"translations"	"ca.wikipedia_page"	"wikidata_id"
"Avenida de la Estación"	"Avinguda de la Estación"	""	""			
"Avenida Aguilera, 2-4"	"Avinguda Aguilera, 2-4"	""	""			
"Avenida de Denia - Canónigo Penalva"	"Avinguda de Denia - Canónigo Penalva"	""	""			
"Avenida Villajoyosa, 2 - Estación de la Marina"	"Avinguda Villajoyosa, 2 - Estación de la Marina"	""	""			
"Avenida Padre Esplá, 53"	"Avinguda Padre Esplá, 53"	""	""			
"Avenida Padre Esplá, 65"	"Avinguda Padre Esplá, 65"	""	""			
"Avenida Padre Esplá, 37"	"Avinguda Padre Esplá, 37"	""	""			
"Avenida de la Universidad - Rabasa I"	"Avinguda de la Universidad - Rabasa I"	""	""			
"Avenida de la Universidad - Rabasa V"	"Avinguda de la Universidad - Rabasa V"	""	""			
"Avenida Villajoyosa, 10"	"Avinguda Villajoyosa, 10"	""	""			
"Avenida Villajoyosa, 30"	"Avinguda Villajoyosa, 30"	""	""			
"Avenida del Hospital"	"Avinguda del Hospital"	""	""			
"Avenida Carlos Soler, 50 (Ayuntamiento)"	"Avinguda Carlos Soler, 50 (Ayuntamiento)"	""	""			
"Avenida De La Generalitat, 36"	"Avinguda De La Generalitat, 36"	""	""			
"Avenida De La Generalitat, 56"	"Avinguda De La Generalitat, 56"	""	""			
"Avenida De La Generalitat, 57"	"Avinguda De La Generalitat, 57"	""	""			
"Avenida De La Generalitat, 39"	"Avinguda De La Generalitat, 39"	""	""			
"Avenida Carrer La Mar, 20"	"Avinguda Carrer La Mar, 20"	""	""			
"Avenida de Elche"	"Avinguda de Elche"	""	""			
"Avenida de la Antigua Peseta"	"Avinguda de la Antigua Peseta"	""	""			
"avenida de la Antigua Peseta"	"avinguda de la Antigua Peseta"	""	""			
"avenida Mare Nostrum"	"avinguda Mare Nostrum"	""	""			
"Avenida de Los Monteros"	"Avinguda de Los Monteros"	""	""			
"avenida de los Monteros"	"avinguda de los Monteros"	""	""			
"avenida de Neptuno"	"avinguda de Neptuno"	""	""			
"Avenida del Zodiaco"	"Avinguda del Zodiaco"	""	""			
"avenida País Valenciano"	"avinguda País Valenciano"	""	""			
"avenida de Jean Claude Combaldieu"	"avinguda de Jean Claude Combaldieu"	""	""			
"Avenida de Europa"	"Avinguda de Europa"	""	""			
"Avenida Victoria Kent Siano"	"Avinguda Victoria Kent Siano"	""	""			
"avenida Alcalde Lorenzo Carbonell"	"avinguda Alcalde Lorenzo Carbonell"	""	""			
"avenida de Saturno"	"avinguda de Saturno"	""	""			
"avenida de Elche"	"avinguda de Elche"	""	""			
"avenida alcalde Lorenzo Carbonell"	"avinguda alcalde Lorenzo Carbonell"	""	""			
"avenida Catedrático Soler"	"avinguda Catedrático Soler"	""	""			
"avenida pianista Gonzalo Soriano"	"avinguda pianista Gonzalo Soriano"	"Gran Vía"	"Gran Vía"			
"avenida doctor Gadea"	"avinguda doctor Gadea"	""	""			
"avenida Eusebio Sempere"	"avinguda Eusebio Sempere"	""	""			
"avenida doctor Ramón y Cajal"	"avinguda doctor Ramón y Cajal"	""	""			
"avenida de Óscar Esplá"	"avinguda de Óscar Esplá"	""	""			
"avenida de Loring"	"avinguda de Loring"	""	""			
"avenida Conde de Vallellano"	"avinguda Conde de Vallellano"	""	""			
"avenida de Orihuela"	"avinguda de Orihuela"	""	""			
"avenida Vicente Blasco Ibáñez"	"avinguda Vicente Blasco Ibáñez"	""	""			
"avenida médico Ricardo Ferré"	"avinguda médico Ricardo Ferré"	""	""			
"avenida de Aguilera"	"avinguda de Aguilera"	""	""			
"Avenida Doctor Jiménez Díaz"	"Avinguda Doctor Jiménez Díaz"	"Gran Vía"	"Gran Vía"			
"Avenida Isla de Corfú"	"Avinguda Isla de Corfú"	""	""			
"avenida doctor Jiménez Díaz"	"avinguda doctor Jiménez Díaz"	""	""			
"avenida doctor Jiménez Díaz"	"avinguda doctor Jiménez Díaz"	"Gran Vía"	"Gran Vía"			
"avenida José Jornet Navarro"	"avinguda José Jornet Navarro"	""	""			
"avenida cardenal Francisco Álvarez"	"avinguda cardenal Francisco Álvarez"	""	""			
"Avenida Deportista Isabel Fernández"	"Avinguda Deportista Isabel Fernández"	""	""			
"avenida ciudad de Wenzhou"	"avinguda ciudad de Wenzhou"	""	""			
"avenida de Jaime I"	"avinguda de Jaime I"	""	""			
"avenida ciudad de Toyooka"	"avinguda ciudad de Toyooka"	""	""			
"Avenida de la Universidad"	"Avinguda de la Universidad"	""	""			
"avenida Jaime I"	"avinguda Jaime I"	""	""			
"avenida de Salamanca"	"avinguda de Salamanca"	""	""			
"avenida Benito Pérez Galdós"	"avinguda Benito Pérez Galdós"	""	""			
"avenida de Maisonnave"	"avinguda de Maisonnave"	""	""			
"avenida general Marvá"	"avinguda general Marvá"	""	""			
"avenida de Federico Soto"	"avinguda de Federico Soto"	""	""			
"Avenida Alfonso X El Sábio"	"Avinguda Alfonso X El Sábio"	""	""			
"avenida de la Constitución"	"avinguda de la Constitución"	""	""			
"avenida de la Estación"	"avinguda de la Estación"	""	""			
"avenida conde de Soto Ameno"	"avinguda conde de Soto Ameno"	""	""			
"avenida de Alcoy"	"avinguda de Alcoy"	""	""			
"avenida doctor Rico"	"avinguda doctor Rico"	""	""			
"avenida poeta Carmelo Calvo"	"avinguda poeta Carmelo Calvo"	""	""			
"Avenida Juan Bautista Lafora"	"Avinguda Juan Bautista Lafora"	""	""			
"Avenida Jaime II"	"Avinguda Jaime II"	""	""			
"Avenida Vázquez de Mella"	"Avinguda Vázquez de Mella"	""	""			
"Avenida de Villajoyosa"	"Avinguda de Villajoyosa"	""	""			
"avenida de Denia"	"avinguda de Denia"	""	""			
"avenida de Jijona"	"avinguda de Jijona"	""	""			
"avenida Diputado José Luis Barceló"	"avinguda Diputado José Luis Barceló"	""	""			
"avenida de Novelda"	"avinguda de Novelda"	""	""			
"avenida maestro Alonso"	"avinguda maestro Alonso"	""	""			
"avenida pintor Baeza"	"avinguda pintor Baeza"	""	""			
"avenida Padre Esplá"	"avinguda Padre Esplá"	""	""			
"Avenida Juan Sanchís Candela"	"Avinguda Juan Sanchís Candela"	"Gran Vía"	"Gran Vía"			
"avenida Juan Sanchis Candela"	"avinguda Juan Sanchis Candela"	"Gran Vía"	"Gran Vía"			
"Avenida Juan Sanchís Candela"	"Avinguda Juan Sanchís Candela"	""	""			
"avenida de Penáguila"	"avinguda de Penáguila"	""	""			
"Avenida 3 de Abril de 1979"	"Avinguda 3 de Abril de 1979"	""	""			
"avenida de los tilos"	"avinguda de los tilos"	""	""			
"Avenida Doctor Marañón"	"Avinguda Doctor Marañón"	""	""			
"avenida de Barcelona"	"avinguda de Barcelona"	""	""			
"avenida de Vicente Savall"	"avinguda de Vicente Savall"	""	""			
"Avenida de Sevilla"	"Avinguda de Sevilla"	""	""			
"avenida de Haygon"	"avinguda de Haygon"	""	""			
"Avenida del Rodalet"	"Avinguda del Rodalet"	""	""			
"avenida de los Almendros"	"avinguda de los Almendros"	""	""			
"avenida del río Turia"	"avinguda del río Turia"	""	""			
"Avenida del Río Turia"	"Avinguda del Río Turia"	""	""			
"avenida Pino Santo"	"avinguda Pino Santo"	""	""			
"Avenida Diputado Antonio García Miralles"	"Avinguda Diputado Antonio García Miralles"	""	""			
"Avenida Pintor Gastón Castelló"	"Avinguda Pintor Gastón Castelló"	""	""			
"avenida Ejércitos Españoles"	"avinguda Ejércitos Españoles"	""	""			
"avenida diputado Antonio García Miralles"	"avinguda diputado Antonio García Miralles"	""	""			
"Avenida de la Ciudad de León de Nicaragua"	"Avinguda de la Ciudad de León de Nicaragua"	""	""			
"avenida de las Brisas"	"avinguda de las Brisas"	""	""			
"avenida pintor Xavier Soler"	"avinguda pintor Xavier Soler"	"Gran Vía"	"Gran Vía"			
"avenida pintor Xavier Soler"	"avinguda pintor Xavier Soler"	""	""			
"Avenida de la Caja de Ahorros"	"Avinguda de la Caja de Ahorros"	""	""			
"Avenida de la Condomina"	"Avinguda de la Condomina"	""	""			
"Avenida Flora de España"	"Avinguda Flora de España"	""	""			
"Avenida Miriam Blasco"	"Avinguda Miriam Blasco"	""	""			
"Avenida Goleta"	"Avinguda Goleta"	""	""			
"Avenida Costa Blanca"	"Avinguda Costa Blanca"	""	""			
"Avenida de Ansaldo"	"Avinguda de Ansaldo"	""	""			
"Avenida Costablanca"	"Avinguda Costablanca"	""	""			
"Avenida Pintor Fernando Soria"	"Avinguda Pintor Fernando Soria"	""	""			
"Avenida del Historiador Vicente Ramos"	"Avinguda del Historiador Vicente Ramos"	""	""			
"Avenida de las Naciones"	"Avinguda de las Naciones"	""	""			
"Avenida de Cataluña"	"Avinguda de Cataluña"	""	""			
"avenida Antonio Ramos Carratalá"	"avinguda Antonio Ramos Carratalá"	""	""			
"Avenida Padre Ángel Escapa"	"Avinguda Padre Ángel Escapa"	""	""			
"Avenida del Locutor Vicente Hipólito"	"Avinguda del Locutor Vicente Hipólito"	""	""			
"avenida Ansaldo"	"avinguda Ansaldo"	""	""			
"Avenida Arquitecto Félix Candela"	"Avinguda Arquitecto Félix Candela"	""	""			
"Avenida de Bruselas"	"Avinguda de Bruselas"	""	""			
"Avenida de los Países Escandinavos"	"Avinguda de los Países Escandinavos"	""	""			
"Avenida de Holanda"	"Avinguda de Holanda"	""	""			
"avenida del fotógrafo Francisco Cano"	"avinguda del fotógrafo Francisco Cano"	""	""			
"Avenida de Oviedo"	"Avinguda de Oviedo"	""	""			
"avenida de las Naciones"	"avinguda de las Naciones"	""	""			
"avenida pintor Pérez Gil"	"avinguda pintor Pérez Gil"	""	""			
"Avenida fotógrafo Francisco Cano"	"Avinguda fotógrafo Francisco Cano"	""	""			
"avenida del arquitecto Félix Candela"	"avinguda del arquitecto Félix Candela"	""	""			
"Avenida Pintor Pérez Gil"	"Avinguda Pintor Pérez Gil"	""	""			
"avenida de Alicante"	"avinguda de Alicante"	""	""			
"Avenida Doctor José Pérez Mateos"	"Avinguda Doctor José Pérez Mateos"	""	""			
"avenida Ausiàs March"	"avinguda Ausiàs March"	""	""			
"Avenida de alicante"	"Avinguda de alicante"	""	""			
"Avenida Dr. Santiago Ramón y Cajal"	"Avinguda Dr. Santiago Ramón y Cajal"	""	""			
"avenida Ausías March"	"avinguda Ausías March"	""	""			
"Avenida de la Cadena"	"Avinguda de la Cadena"	""	""			
"avenida Conrado Albadalejo"	"avinguda Conrado Albadalejo"	""	""			
"Avenida Músico Maestro Antonio Climent"	"Avinguda Músico Maestro Antonio Climent"	""	""			
"avenida de Elda"	"avinguda de Elda"	""	""			
"avenida de Madrid"	"avinguda de Madrid"	""	""			
"avenida de los Cabos"	"avinguda de los Cabos"	""	""			
"avenida de los Minerales - Garroferal"	"avinguda de los Minerales - Garroferal"	""	""			
"avenida de los Pescados"	"avinguda de los Pescados"	""	""			
"avenida de la Industria"	"avinguda de la Industria"	""	""			
"avenida Primero de Mayo"	"avinguda Primero de Mayo"	""	""			
"Avenida de la Libertad"	"Avinguda de la Libertad"	""	""			
"Avenida Ancha de Castelar"	"Avinguda Ancha de Castelar"	""	""			
"Avenida de Los Ríos - Finca Don Jaime"	"Avinguda de Los Ríos - Finca Don Jaime"	""	""			
"avenida del Ciervo"	"avinguda del Ciervo"	""	""			
"avenida del Plà - Olivera"	"avinguda del Plà - Olivera"	""	""			
"avenida de la Astronomía"	"avinguda de la Astronomía"	""	""			
"avenida de Francisco Bernabeu Penalva"	"avinguda de Francisco Bernabeu Penalva"	""	""			
"avenida Aves - Plà Xirau"	"avinguda Aves - Plà Xirau"	""	""			
"avenida de la Música"	"avinguda de la Música"	""	""			
"avenida de las Islas - Canyada Alcoi"	"avinguda de las Islas - Canyada Alcoi"	""	""			
"avenida Blasco Ibáñez"	"avinguda Blasco Ibáñez"	""	""			
"Avenida de los Girasoles"	"Avinguda de los Girasoles"	""	""			
"Avenida de Tángel"	"Avinguda de Tángel"	""	""			
"avenida de Tángel"	"avinguda de Tángel"	""	""			
"Avenida Diagonal"	"Avinguda Diagonal"	""	""			
"avenida Secretario Basilio Sala"	"avinguda Secretario Basilio Sala"	""	""			
"avenida del Instituto"	"avinguda del Instituto"	""	""			
"avenida Catedrático Sala Pérez"	"avinguda Catedrático Sala Pérez"	""	""			
"Avenida de Benidorm"	"Avinguda de Benidorm"	""	""			
"Avenida Miguel Hernández"	"Avinguda Miguel Hernández"	""	""			
"avenida de Carlos Soler"	"avinguda de Carlos Soler"	""	""			
"avenida de Ansaldo"	"avinguda de Ansaldo"	""	""			
"avenida de los Patos"	"avinguda de los Patos"	""	""			
"Avenida de Santander"	"Avinguda de Santander"	""	""			
"Avenida San Sebastián"	"Avinguda San Sebastián"	""	""			
"Avenida de Niza"	"Avinguda de Niza"	""	""			
"Avenida de Nápoles"	"Avinguda de Nápoles"	""	""			
"avenida maestro José Garberí Serrano"	"avinguda maestro José Garberí Serrano"	""	""			
"avenida artista Remigio Soler"	"avinguda artista Remigio Soler"	""	""			
"avenida maestro José Garberí"	"avinguda maestro José Garberí"	""	""			
"Avenida de Irlanda"	"Avinguda de Irlanda"	""	""			
"avenida de La Cruz"	"avinguda de La Cruz"	""	""			
"avenida de Ausias March"	"avinguda de Ausias March"	""	""			
"Avenida de Alcoy"	"Avinguda de Alcoy"	""	""			
"avenida Almadrava"	"avinguda Almadrava"	""	""			
"avenida de España"	"avinguda de España"	""	""			
"Avenida Doctor Sapena"	"Avinguda Doctor Sapena"	""	""			
"avenida de América"	"avinguda de América"	""	""			
"avenida del Carritxal"	"avinguda del Carritxal"	""	""			
"Avenida"	"Avenida"					
"Avenida Valencia - Plaza de la Libertad"	"Avinguda Valencia - Plaza de la Libertad"					
"Avenida Valencia - Grupo Virgen del Lidón"	"Avinguda Valencia - Grupo Virgen del Lidón"					
"Avenida Burriana, 4"	"Avinguda Burriana, 4"					
"Avenida Valencia 27"	"Avinguda Valencia 27"					
"Avenida Valencia 28"	"Avinguda Valencia 28"					
"Avenida Burriana, 22"	"Avinguda Burriana, 22"					
"Avenida Casalduch - Carmelitas"	"Avinguda Casalduch - Carmelitas"					
"Avenida Barcelona (Col·legi Gaetà Huguet)"	"Avinguda Barcelona (Col·legi Gaetà Huguet)"					
"Avenida del Mar 3"	"Avinguda del Mar 3"					
"Avenida del Mar / Antiguo Asilo"	"Avinguda del Mar / Antiguo Asilo"					
"Avenida del Mar / Columbretes"	"Avinguda del Mar / Columbretes"					
"Avenida del Mar 43"	"Avinguda del Mar 43"					
"Avenida del Mar / Torreblanca"	"Avinguda del Mar / Torreblanca"					
"Avenida Capuchinos 14"	"Avinguda Capuchinos 14"					
"Avenida Capuchinos 36"	"Avinguda Capuchinos 36"					
"Avenida Capuchinos (Plaza del Primer Molí)"	"Avinguda Capuchinos (Plaza del Primer Molí)"					
"Avenida del Mar / Donación"	"Avinguda del Mar / Donación"					
"Avenida 150"	"Avinguda 150"					
"Avenida del Mar / Recinto Ferial"	"Avinguda del Mar / Recinto Ferial"					
"Avenida del Mar / Autovía Puerto"	"Avinguda del Mar / Autovía Puerto"					
"Avenida Diputación - Grupo San Agustín"	"Avinguda Diputación - Grupo San Agustín"					
"Avenida del Mar / Patos"	"Avinguda del Mar / Patos"					
"Avenida del Mar / Instituto"	"Avinguda del Mar / Instituto"					
"Avenida Mohíno esquina Calle Florida"	"Avinguda Mohíno esquina Calle Florida"					
"Avenida del Grao"	"Avinguda del Grao"					
"Avenida Casalduch"	"Avinguda Casalduch"					
"Avenida Mediterránea"	"Avinguda Mediterránea"					
"Avenida Pla de la Torre"	"Avinguda Pla de la Torre"					
"Avenida del Meridiano"	"Avinguda del Meridiano"					
"Avenida del Torrello"	"Avinguda del Torrello"					
"Avenida del Boverot"	"Avinguda del Boverot"					
"Avenida del Espliego"	"Avinguda del Espliego"					
"Avenida Correntilla"	"Avinguda Correntilla"					
"Avenida Saboner"	"Avinguda Saboner"					
"Avenida Ribesalbes"	"Avinguda Ribesalbes"					
"Avenida de Lairón"	"Avinguda de Lairón"					
"Avenida Enrique Gimeno"	"Avinguda Enrique Gimeno"					
"Avenida de Enrique Gimeno"	"Avinguda de Enrique Gimeno"					
"Avenida de Villarreal"	"Avinguda de Villarreal"					
"Avenida Vicent Sos Baynat"	"Avinguda Vicent Sos Baynat"					
"Avenida Campos Elíseos"	"Avinguda Campos Elíseos"					
"Avenida Recoletos"	"Avinguda Recoletos"					
"Avenida de Estados Unidos"	"Avinguda de Estados Unidos"					
"Avenida Parque Oeste"	"Avinguda Parque Oeste"					
"Avenida Doctor Clará"	"Avinguda Doctor Clará"					
"Avenida Pérez Galdós"	"Avinguda Pérez Galdós"					
"Avenida Cardenal Costa"	"Avinguda Cardenal Costa"					
"Avenida Virgen de Lidón"	"Avinguda Virgen de Lidón"					
"Avenida Bulevard Vicente Blasco Ibáñez"	"Avinguda Bulevard Vicente Blasco Ibáñez"					
"Avenida Capuchinos"	"Avinguda Capuchinos"					
"Avenida del Puerto"	"Avinguda del Puerto"					
"Avenida del Golf"	"Avinguda del Golf"					
"Avenida Plano"	"Avinguda Plano"					
"Avenida de las Hermanas Núñez Gascó"	"Avinguda de las Hermanas Núñez Gascó"					
"Avenida del Campo"	"Avinguda del Campo"					
"Avenida de Villafranca"	"Avinguda de Villafranca"					
"Avenida Ferrandis Salvador"	"Avinguda Ferrandis Salvador"					
"Avenida de las Conchas"	"Avinguda de las Conchas"					
"Avenida de Castalia"	"Avinguda de Castalia"					
"Avenida del Ferrocarril"	"Avinguda del Ferrocarril"					
"Avenida de España"	"Avinguda de España"					
"Avenida de Costa Rica"	"Avinguda de Costa Rica"					
"Avenida de Argentina"	"Avinguda de Argentina"					
"Avenida del Maestrat"	"Avinguda del Maestrat"					
"Avenida del Faro"	"Avinguda del Faro"					
"Avenida Doctor Bellido"	"Avinguda Doctor Bellido"					
"Avenida de la Plana"	"Avinguda de la Plana"					
"Avenida Colada del Pou Nou"	"Avinguda Colada del Pou Nou"					
"Avenida Colada de la Casilla"	"Avinguda Colada de la Casilla"					
"Avenida Camino de l'Atall"	"Avinguda Camino de l'Atall"					
"Avenida Castillo de Albalat"	"Avinguda Castillo de Albalat"					
"Avenida del Grabador Fabregat"	"Avinguda del Grabador Fabregat"					
"Avenida Carrassa Mon Rosí"	"Avinguda Carrassa Mon Rosí"					
"Avenida I"	"Avinguda I"	""	""			
"Avenida 16"	"Avinguda 16"	""	""			
"Avenida-19"	"Avenida-19"	""	""			
"Avenida II"	"Avinguda II"	""	""			
"Avenida Catedratico José Maria. Bernabé Maestre"	"Avinguda Catedratico José Maria. Bernabé Maestre"	""	""			
"Avenida de la Libertad (pasado cruce)"	"Avinguda de la Libertad (pasado cruce)"	""	""			
"Avenida de la Libertad (policia Local)"	"Avinguda de la Libertad (policia Local)"	""	""			
"Avenida Catedratico José Maria Bernabé Maestre (Restaurante la Molineta)"	"Avinguda Catedratico José Maria Bernabé Maestre (Restaurante la Molineta)"	""	""			
"Avenida Madrd, 10"	"Avinguda Madrd, 10"	""	""			
"Avenida Madrd, 7"	"Avinguda Madrd, 7"	""	""			
"Avenida Elda, 74"	"Avinguda Elda, 74"	""	""			
"Avenida Madrd, 37"	"Avinguda Madrd, 37"	""	""			
"Avenida Elda, 36"	"Avinguda Elda, 36"	""	""			
"Avenida Madrd, 36"	"Avinguda Madrd, 36"	""	""			
"Avenida Elda, (Panaderia Amorós)"	"Avinguda Elda, (Panaderia Amorós)"	""	""			
"Avenida Elda, 102"	"Avinguda Elda, 102"	""	""			
"Avenida de Salinetas, 40"	"Avinguda de Salinetas, 40"	""	""			
"Avenida de Salinetas, s/n"	"Avinguda de Salinetas, s/n"	""	""			
"Avenida de Hipanoamérica (Colonia la Foia)"	"Avinguda de Hipanoamérica (Colonia la Foia)"	""	""			
"Avenida de Hipanoamérica, 36"	"Avinguda de Hipanoamérica, 36"	""	""			
"Avenida de Hipanoamérica, 16"	"Avinguda de Hipanoamérica, 16"	""	""			
"Avenida de Hipanoamérica, 17"	"Avinguda de Hipanoamérica, 17"	""	""			
"Avenida de la Constitución"	"Avinguda de la Constitución"	""	""			
"avenida de Barbarroja"	"avinguda de Barbarroja"	""	""			
"Avenida Enrique Pastor"	"Avinguda Enrique Pastor"	""	""			
"Avenida de Albatera"	"Avinguda de Albatera"	""	""			
"Avenida de Novelda"	"Avinguda de Novelda"	""	""			
"Avenida de Valencia"	"Avinguda de Valencia"	""	""			
"avenida de San Isidro"	"avinguda de San Isidro"	""	""			
"avenida Salvador"	"avinguda Salvador"	""	""			
"Avenida de Alicante"	"Avinguda de Alicante"	""	""			
"Avenida de Castellón"	"Avinguda de Castellón"	""	""			
"Avenida de Crevillente"	"Avinguda de Crevillente"	""	""			
"Avenida Virgen de las Nieves"	"Avinguda Virgen de las Nieves"	""	""			
"Avenida Tolomó"	"Avinguda Tolomó"	""	""			
"Avenida Pablo Iglesias"	"Avinguda Pablo Iglesias"	""	""			
"Avenida Emilio Castelar"	"Avinguda Emilio Castelar"	""	""			
"Avenida de la Enseñanza"	"Avinguda de la Enseñanza"	""	""			
"avenida de la Comunidad Valenciana"	"avinguda de la Comunidad Valenciana"	""	""			
"avenida de los Reyes Católicos"	"avinguda de los Reyes Católicos"	""	""			
"Avenida Ingeniero Enrique Santo"	"Avinguda Ingeniero Enrique Santo"	""	""			
"avenida Ingeniero Enrique Santo"	"avinguda Ingeniero Enrique Santo"	""	""			
"avenida de la Libertad"	"avinguda de la Libertad"	""	""			
"avenida Alfonso X el Sabio"	"avinguda Alfonso X el Sabio"	""	""			
"Avenida de los Reyes Católicos"	"Avinguda de los Reyes Católicos"	""	""			
"avenida del Cementerio Viejo"	"avinguda del Cementerio Viejo"	""	""			
"Avenida del Vinalopó"	"Avinguda del Vinalopó"	""	""			
"avenida del Vinalopó"	"avinguda del Vinalopó"	""	""			
"avenida Compositor Vicente Díez Clemente"	"avinguda Compositor Vicente Díez Clemente"	""	""			
"Avenida Benito Pérez Galdós"	"Avinguda Benito Pérez Galdós"	""	""			
"avenida del Médico Enrique Sala"	"avinguda del Médico Enrique Sala"	""	""			
"Avenida de Petrer"	"Avinguda de Petrer"	""	""			
"avenida de Jesús Navarro Jover"	"avinguda de Jesús Navarro Jover"	""	""			
"Avenida José Martínez González"	"Avinguda José Martínez González"	"Gran Avinguda José Martínez González"	"Gran Avenida José Martínez González"			
"Avenida del Mediterráneo"	"Avinguda del Mediterráneo"	""	""			
"Avenida Catedrático José María Bernabé Maestre"	"Avinguda Catedrático José María Bernabé Maestre"	""	""			
"Avenida Suroeste"	"Avinguda Suroeste"					
"Avenida Jaime I El Conquistador"	"Avinguda Jaime I El Conquistador"					
"Avenida Arcadio García i Sanz"	"Avinguda Arcadio García i Sanz"					
"Avenida España"	"Avinguda España"					
"Avenida Agricultor"	"Avinguda Agricultor"					
"Avenida Cortes Valencianas"	"Avinguda Cortes Valencianas"					
"Avenida de Hagunia"	"Avinguda de Hagunia"					
"Avenida Angunia"	"Avinguda Angunia"					
"Avenida Corazón de Jesús"	"Avinguda Corazón de Jesús"					
"Avenida de Chilches"	"Avinguda de Chilches"					
"Avenida de Europa"	"Avinguda de Europa"					
"Avenida de Vora Riu"	"Avinguda de Vora Riu"					
"Avenida de las Cortes Valencianas"	"Avinguda de las Cortes Valencianas"					
"Avenida de la Generalitat"	"Avinguda de la Generalitat"					
"Avenida de los Pescadores"	"Avinguda de los Pescadores"					
"Avenida del Científico Avelino Corma"	"Avinguda del Científico Avelino Corma"					
"Avenida del Mare Nostrum"	"Avinguda del Mare Nostrum"					
"Avenida Senda Mitjana"	"Avinguda Senda Mitjana"					
"Avenida del Mijares"	"Avinguda del Mijares"					
"Avenida Nyons"	"Avinguda Nyons"					
"Avenida Montendre"	"Avinguda Montendre"					
"Avenida de las Madres de la Plaza de Mayo"	"Avinguda de las Madres de la Plaza de Mayo"					
"Avenida de Roma"	"Avinguda de Roma"					
"Avenida Mediterráneo"	"Avinguda Mediterráneo"					
"Avenida Alcora"	"Avinguda Alcora"					
"Avenida Betxí"	"Avinguda Betxí"					
"Avenida País Valenciano"	"Avinguda País Valenciano"					
"Avenida el Tordo"	"Avinguda el Tordo"					
"Avenida Castilla la Mancha"	"Avinguda Castilla la Mancha"					
"Avenida Asturias"	"Avinguda Asturias"					
"Avenida Real de Extremadura"	"Avinguda Real de Extremadura"					
"Avenida Extremadura"	"Avinguda Extremadura"					
"Avenida Sierra Espadán"	"Avinguda Sierra Espadán"					
"Avenida Manuel Escobedo"	"Avinguda Manuel Escobedo"					
"Avenida Profesor Eulogio Oset"	"Avinguda Profesor Eulogio Oset"					
"Avenida de Bellaguardia"	"Avinguda de Bellaguardia"					
"Avenida Mosén Joan Miralles"	"Avinguda Mosén Joan Miralles"					
"Avenida de Mosén Herminio Pérez"	"Avinguda de Mosén Herminio Pérez"					
"Avenida Sonella"	"Avinguda Sonella"					
"Avenida Cañada Blanch"	"Avinguda Cañada Blanch"					
"Avenida Jaime Chicharro"	"Avinguda Jaime Chicharro"					
"Avenida de la Unión Europea"	"Avinguda de la Unión Europea"					
"Avenida del Cedre"	"Avinguda del Cedre"					
"Avenida"	"Avenida"	""	""			
"Avenida Uno"	"Avinguda Uno"	""	""			
"Avenida Europa"	"Avinguda Europa"	""	""			
"Avenida de Montbenidorm"	"Avinguda de Montbenidorm"	""	""			
"Avenida de Puerto Rico"	"Avinguda de Puerto Rico"	""	""			
"Avenida de Bolivia"	"Avinguda de Bolivia"	""	""			
"Avenida Jaime I"	"Avinguda Jaime I"	""	""			
"Avenida de la Marina Baixa"	"Avinguda de la Marina Baixa"	""	""			
"Avenida de Panamá"	"Avinguda de Panamá"	""	""			
"Avenida de Los Limones"	"Avinguda de Los Limones"	""	""			
"Avenida de Alfonso Puchades"	"Avinguda de Alfonso Puchades"	""	""			
"Avenida de la Ciudad Deportiva"	"Avinguda de la Ciudad Deportiva"	""	""			
"Avenida del periodista y escritor Emilio Romero"	"Avinguda del periodista y escritor Emilio Romero"	""	""			
"Avenida del Doctor Orts Llorca"	"Avinguda del Doctor Orts Llorca"	""	""			
"Avenida Sacerdote D. Juan Andrés Rodríguez Serrano"	"Avinguda Sacerdote D. Juan Andrés Rodríguez Serrano"	""	""			
"Avenida del Alcalde Manuel Catalán Chana"	"Avinguda del Alcalde Manuel Catalán Chana"	""	""			
"Avenida de Tokio"	"Avinguda de Tokio"	""	""			
"Avenida de Roma"	"Avinguda de Roma"	""	""			
"Avenida de París"	"Avinguda de París"	""	""			
"Avenida de Estocolmo"	"Avinguda de Estocolmo"	""	""			
"Avenida de Madrid"	"Avinguda de Madrid"	""	""			
"Avenida Alfonso Puchades"	"Avinguda Alfonso Puchades"	""	""			
"Avenida de Francia"	"Avinguda de Francia"	""	""			
"Avenida Inglaterra"	"Avinguda Inglaterra"	""	""			
"Avenida de Noruega"	"Avinguda de Noruega"	"Avinguda de Suecia"	"Avenida de Suecia"			
"Avenida del Derramador"	"Avinguda del Derramador"	""	""			
"Avenida Alcalde Eduardo Zaplana Hernández-Soto"	"Avinguda Alcalde Eduardo Zaplana Hernández-Soto"	""	""			
"Avenida de Montecarlo"	"Avinguda de Montecarlo"	""	""			
"Avenida de Paris"	"Avinguda de Paris"	""	""			
"Avenida del Doctor Severo Ochoa"	"Avinguda del Doctor Severo Ochoa"	""	""			
"Avenida de Marsella"	"Avinguda de Marsella"	""	""			
"Avenida Varsovia"	"Avinguda Varsovia"	""	""			
"Avenida de Malta"	"Avinguda de Malta"	""	""			
"Avenida del Albir"	"Avinguda del Albir"	""	""			
"Avenida de la Comunidad Valenciana"	"Avinguda de la Comunidad Valenciana"	""	""			
"Avenida Balcón del Ponoch"	"Avinguda Balcón del Ponoch"	""	""			
"Avenida País Valencià"	"Avinguda País Valencià"	""	""			
"Avenida Felipe V"	"Avinguda Felipe V"					
"Avenida Torre de Eiffel"	"Avinguda Torre de Eiffel"					
"Avenida de Las Salinas"	"Avinguda de Las Salinas"					
"Avenida Peña de las Águilas"	"Avinguda Peña de las Águilas"					
"avenida Don Bosco"	"avinguda Don Bosco"					
"avenida de Dolores"	"avinguda de Dolores"					
"avenida Circunvalación Sur"	"avinguda Circunvalación Sur"					
"avenida de Aldaya"	"avinguda de Aldaya"					
"avenida de Novelda"	"avinguda de Novelda"					
"avenida presidente Lázaro Cárdenenas del Río"	"avinguda presidente Lázaro Cárdenenas del Río"					
"Avenida de Santa Pola"	"Avinguda de Santa Pola"					
"avenida del Ferrocarril"	"avinguda del Ferrocarril"					
"Avenida de la Universidad de Elche"	"Avinguda de la Universidad de Elche"					
"avenida Bimil·lenari"	"avinguda Bimil·lenari"					
"avenida de la U.N.E.S.C.O."	"avinguda de la U.N.E.S.C.O."					
"avenida del Altet"	"avinguda del Altet"					
"avenida de la Universidad de Elche"	"avinguda de la Universidad de Elche"					
"Avenida del Calzado de Elche"	"Avinguda del Calzado de Elche"					
"Avenida de Tamarit"	"Avinguda de Tamarit"					
"Avenida de Ronda"	"Avinguda de Ronda"					
"Avenida de Salamanca"	"Avinguda de Salamanca"					
"Avenida de Murcia"	"Avinguda de Murcia"					
"Avenida de la Virgen del Pilar"	"Avinguda de la Virgen del Pilar"					
"Avenida de Cristóbal Sanz"	"Avinguda de Cristóbal Sanz"					
"Avenida de Jesús Astondoa Santamaría"	"Avinguda de Jesús Astondoa Santamaría"					
"Avenida de los Baños"	"Avinguda de los Baños"					
"Avenida de Santiago"	"Avinguda de Santiago"					
"Avenida El Catalanet"	"Avinguda El Catalanet"					
"Avenida de la Armada Española"	"Avinguda de la Armada Española"					
"Avenida de Oscar Esplà"	"Avinguda de Oscar Esplà"					
"Avenida de la Torre de Pep"	"Avinguda de la Torre de Pep"					
"Avenida de Canarias"	"Avinguda de Canarias"					
"Avenida del Carabasi"	"Avinguda del Carabasi"					
"Avenida de África"	"Avinguda de África"					
"Avenida de Asia"	"Avinguda de Asia"					
"Avenida de Oceanía"	"Avinguda de Oceanía"					
"Avenida del País Valenciano"	"Avinguda del País Valenciano"					
"avenida Costa Blanca"	"avinguda Costa Blanca"					
"Avenida de los Gremios"	"Avinguda de los Gremios"					
"Avenida de los Ceramistas"	"Avinguda de los Ceramistas"					
"Avenida Puerto de Castellón"	"Avinguda Puerto de Castellón"					
"Avenida Puerto de Alicante"	"Avinguda Puerto de Alicante"					
"Avenida Puerto de Sagunto"	"Avinguda Puerto de Sagunto"					
"Avenida de Turia"	"Avinguda de Turia"					
"Avenida de Italia"	"Avinguda de Italia"					
"Avenida Ribarroja del Turia"	"Avinguda Ribarroja del Turia"					
"Avenida Antic Regne"	"Avinguda Antic Regne"					
"Avenida San Antonio de Benagéber"	"Avinguda San Antonio de Benagéber"					
"Avenida del Camp del Turia"	"Avinguda del Camp del Turia"					
"Avenida Mar Mediterraneo"	"Avinguda Mar Mediterraneo"					
"Avenida de babor"	"Avinguda de babor"					
"Avenida del Pozo de la Salud"	"Avinguda del Pozo de la Salud"					
"Avenida del Puente de San Vicente"	"Avinguda del Puente de San Vicente"					
"Avenida Caja de Ahorros"	"Avinguda Caja de Ahorros"					
"Avenida del Azahar"	"Avinguda del Azahar"					
"Avenida Cortes del Medio"	"Avinguda Cortes del Medio"					
"Avenida de Hendaya"	"Avinguda de Hendaya"					
"Avenida de la Eliana"	"Avinguda de la Eliana"					
"Avenida Mar Balear"	"Avinguda Mar Balear"					
"Avenida 2000"	"Avinguda 2000"					
"Avenida Huerto San Narciso"	"Avinguda Huerto San Narciso"					
"Avenida de Domeño"	"Avinguda de Domeño"					
"Avenida de Barak Obama"	"Avinguda de Barak Obama"					
"Avenida Monterodeno"	"Avinguda Monterodeno"					
"Avenida de los Valles"	"Avinguda de los Valles"					
"Avenida Monte Pinar"	"Avinguda Monte Pinar"					
"Avenida Olimpica"	"Avinguda Olimpica"					
"Avenida Santa María del Puig"	"Avinguda Santa María del Puig"					
"Avenida de Ricardo Capella"	"Avinguda de Ricardo Capella"					
"Avenida de Pablo Iglesias"	"Avinguda de Pablo Iglesias"					
"Avenida del Arenal"	"Avinguda del Arenal"					
"Avenida de la Generalitat Valenciana"	"Avinguda de la Generalitat Valenciana"					
"Avenida Nueve de Octubre"	"Avinguda Nueve de Octubre"					
"Avenida de las Comarcas Valencianas"	"Avinguda de las Comarcas Valencianas"					
"Avenida del Arquitecto Salvador Pascual"	"Avinguda del Arquitecto Salvador Pascual"					
"Avenida del General Palafox"	"Avinguda del General Palafox"					
"Avenida del Turia"	"Avinguda del Turia"					
"Avenida de la Virgen de los Desamparados"	"Avinguda de la Virgen de los Desamparados"					
"Avenida del Camino de Cheste"	"Avinguda del Camino de Cheste"					
"Avenida de Villalba de Lugo"	"Avinguda de Villalba de Lugo"					
"Avenida de Don Santiago Ramón y Cajal"	"Avinguda de Don Santiago Ramón y Cajal"					
"Avenida de Castilla"	"Avinguda de Castilla"					
"Avenida del Mas de l'Oli"	"Avinguda del Mas de l'Oli"					
"Avenida del Barranco Barato"	"Avinguda del Barranco Barato"					
"Avenida del Regimiento Guadalajara 20"	"Avinguda del Regimiento Guadalajara 20"					
"Avenida de Las Cortes Valencianas"	"Avinguda de Las Cortes Valencianas"					
"Avenida Tiro de Pichón"	"Avinguda Tiro de Pichón"					
"Avenida de las Ferias"	"Avinguda de las Ferias"					
"Avenida Juan Carlos I, 74"	"Avinguda Juan Carlos I, 74"					
"Avenida Juan Carlos I, 39"	"Avinguda Juan Carlos I, 39"					
"Avenida Juan Carlos I, 46"	"Avinguda Juan Carlos I, 46"					
"Avenida de Villena"	"Avinguda de Villena"					
"Avenida Fernando Fenoll Bergua"	"Avinguda Fernando Fenoll Bergua"					
"Avenida Los Chopos"	"Avinguda Los Chopos"					
"Avenida Moreras"	"Avinguda Moreras"					
"avenida de Castalla"	"avinguda de Castalla"					
"Avenida de Castalla"	"Avinguda de Castalla"					
"Avenida Centernario de América"	"Avinguda Centernario de América"					
"Avenida Juguete"	"Avinguda Juguete"					
"Avenida Provincia"	"Avinguda Provincia"					
"Avenida Riu de las Caixes"	"Avinguda Riu de las Caixes"					
"Avenida Camino del Cementerio"	"Avinguda Camino del Cementerio"					
"Avenida Hermanos Grimm"	"Avinguda Hermanos Grimm"					
"Avenida V Centenario"	"Avinguda V Centenario"					
"Avenida Joaquín Vilanova"	"Avinguda Joaquín Vilanova"					
"Avenida Costera Samper"	"Avinguda Costera Samper"					
"Avenida Diputación Valenciana"	"Avinguda Diputación Valenciana"					
"Avenida del Xúquer"	"Avinguda del Xúquer"					
"Avenida del Regne de València"	"Avinguda del Regne de València"					
"Avenida de la Muntanyeta"	"Avinguda de la Muntanyeta"					
"Avenida la Glorieta"	"Avinguda la Glorieta"					
"Avenida 25 de Abril"	"Avinguda 25 de Abril"					
"Avenida Mediterranea"	"Avinguda Mediterranea"					
"Avenida Antonio Lloret"	"Avinguda Antonio Lloret"					
"Avenida de Salvador Allende"	"Avinguda de Salvador Allende"					
"Avenida de Tarragona"	"Avinguda de Tarragona"					
"Avenida Luís Suñer"	"Avinguda Luís Suñer"					
"Avenida del Dret d'Associació"	"Avinguda del Dret d'Associació"					
"Avenida Josefa Ahuir"	"Avinguda Josefa Ahuir"					
"Avenida Bernat Guinovart"	"Avinguda Bernat Guinovart"					
"Avenida Corts Valencianes"	"Avinguda Corts Valencianes"					
"Avenida del Carrascalet"	"Avinguda del Carrascalet"					
"Avenida de los Lagos"	"Avinguda de los Lagos"					
"Avenida de Pego I"	"Avinguda de Pego I"					
"Avenida de Pego IIi"	"Avinguda de Pego IIi"					
"Avenida de Pego IV"	"Avinguda de Pego IV"					
"Avenida Monte Pego Ráfol"	"Avinguda Monte Pego Ráfol"					
"Avenida Internacional"	"Avinguda Internacional"					
"Avenida Casanova"	"Avinguda Casanova"					
"Avenida del País Valencia"	"Avinguda del País Valencia"					
"Avenida Polonia"	"Avinguda Polonia"					
"Avenida del Port"	"Avinguda del Port"					
"Avenida Rumania"	"Avinguda Rumania"					
"Avenida de la Rosa de los Vientos"	"Avinguda de la Rosa de los Vientos"					
"avenida de la Fustera"	"avinguda de la Fustera"					
"avenida dels Garcíes"	"avinguda dels Garcíes"					
"avenida del Mediterrani"	"avinguda del Mediterrani"					
"avenida del Baladrar"	"avinguda del Baladrar"					
"Avenida de Estrasburgo"	"Avinguda de Estrasburgo"					
"Avenida via Augusta"	"Avinguda via Augusta"					
"Avenida de Paris"	"Avinguda de Paris"					
"Avenida Blasco Ibañez"	"Avinguda Blasco Ibañez"					
"Avenida Rambleta"	"Avinguda Rambleta"					
"Avenida Santo Espíritu"	"Avinguda Santo Espíritu"					
"Avenida Plá D'Aguiló"	"Avinguda Plá D'Aguiló"					
"Avenida Virgen de la Estrella"	"Avinguda Virgen de la Estrella"					
"Avenida la Pinata"	"Avinguda la Pinata"					
"Avenida Pico del Águila"	"Avinguda Pico del Águila"					
"Avenida Deportiva"	"Avinguda Deportiva"					
"Avenida Montaneta del Salero"	"Avinguda Montaneta del Salero"					
"Avenida Font del Pi"	"Avinguda Font del Pi"					
"Avenida Sants de la Pedra"	"Avinguda Sants de la Pedra"					
"Avenida de Palmosa"	"Avinguda de Palmosa"					
"Avenida de la Alqueria del Agua Fresca"	"Avinguda de la Alqueria del Agua Fresca"					
"Avenida de Juan de Austria"	"Avinguda de Juan de Austria"					
"Avenida Estacion"	"Avinguda Estacion"					
"Avenida Blasco Ibánez"	"Avinguda Blasco Ibánez"					
"Avenida Camí Reial"	"Avinguda Camí Reial"					
"Avenida Antic Regne de Valencia"	"Avinguda Antic Regne de Valencia"					
"Avenida de la Vital"	"Avinguda de la Vital"					
"Avenida Josep Pedrós"	"Avinguda Josep Pedrós"					
"Avenida de la Mediterránea"	"Avinguda de la Mediterránea"					
"Avenida Pais Valencia"	"Avinguda Pais Valencia"					
"Avenida de la Mar Mediterránea"	"Avinguda de la Mar Mediterránea"					
"Avenida Roger de Lauria"	"Avinguda Roger de Lauria"					
"Avenida Neptuno"	"Avinguda Neptuno"					
"Avenida Demetrio Pi"	"Avinguda Demetrio Pi"					
"Avenida de Demetrio Pi"	"Avinguda de Demetrio Pi"					
"Avenida San Joan de Ribera"	"Avinguda San Joan de Ribera"					
"Avenida de Almaig"	"Avinguda de Almaig"					
"Avenida de Vicente Gironés Mora"	"Avinguda de Vicente Gironés Mora"					
"Avenida Daniel Gil"	"Avinguda Daniel Gil"					
"Avenida del Textil"	"Avinguda del Textil"					
"Avenida de Albaida"	"Avinguda de Albaida"					
"Avenida Vall d'Albaida"	"Avinguda Vall d'Albaida"					
"Avenida del Vimen"	"Avinguda del Vimen"					
"Avenida del Plástico"	"Avinguda del Plástico"					
"Avenida del Vidrio"	"Avinguda del Vidrio"					
"Avenida Balneario"	"Avinguda Balneario"					
"Avenida Pobla del Duc"	"Avinguda Pobla del Duc"					
"Avenida Vicente Boluda Palop"	"Avinguda Vicente Boluda Palop"					
"Avenida de Játiva"	"Avinguda de Játiva"					
"Avenida de Francisco Císcar"	"Avinguda de Francisco Císcar"					
"Avenida de Espioca"	"Avinguda de Espioca"					
"Avenida Padre Carlos Ferris"	"Avinguda Padre Carlos Ferris"					
"Avenida de José Alba Alba"	"Avinguda de José Alba Alba"					
"Avenida de la Alquería de Mina"	"Avinguda de la Alquería de Mina"					
"Avenida del Camí Nou"	"Avinguda del Camí Nou"					
"Avenida de Pep de l'Horta"	"Avinguda de Pep de l'Horta"					
"Avenida de Antonio Muñoz"	"Avinguda de Antonio Muñoz"					
"Avenida del Estany"	"Avinguda del Estany"					
"Avenida del Arroz"	"Avinguda del Arroz"					
"Avenida del Mestre Serrano"	"Avinguda del Mestre Serrano"					
"Avenida Don Antonio Molina Meliá"	"Avinguda Don Antonio Molina Meliá"					
"Avenida Constitució"	"Avinguda Constitució"					
"Avenida Verge del Castell"	"Avinguda Verge del Castell"					
"Avenida del Racó"	"Avinguda del Racó"					
"Avenida de la Ciudad de Alicante"	"Avinguda de la Ciudad de Alicante"					
"Avenida de la Ribera Baixa"	"Avinguda de la Ribera Baixa"					
"Avenida Restaurante Lounge Bar"	"Avinguda Restaurante Lounge Bar"					
"Avenida de Manila"	"Avinguda de Manila"					
"Avenida de las Fuentes"	"Avinguda de las Fuentes"					
"Avenida de Daniel Montull"	"Avinguda de Daniel Montull"					
"Avenida Físico Garcia Moliner"	"Avinguda Físico Garcia Moliner"					
"Avenida de la Serra d'Irta"	"Avinguda de la Serra d'Irta"					
"Avenida Eugenio J. Mir y Mir"	"Avinguda Eugenio J. Mir y Mir"					
"Avenida Doctor Don Marcelino Roca"	"Avinguda Doctor Don Marcelino Roca"					
"Avenida Papa Luna"	"Avinguda Papa Luna"					
"Avenida Gil de Atrocillo"	"Avinguda Gil de Atrocillo"					
"Avenida 2.0"	"Avinguda 2.0"					
"Avenida de los Jazmines"	"Avinguda de los Jazmines"					
"Avenida del Barón de Campolivar"	"Avinguda del Barón de Campolivar"					
"Avenida de las Melias"	"Avinguda de las Melias"					
"Avenida de las Jacarandas"	"Avinguda de las Jacarandas"					
"Avenida de la Ilustración"	"Avinguda de la Ilustración"					
"Avenida de Pi y Margall"	"Avinguda de Pi y Margall"					
"Avenida de María Ros"	"Avinguda de María Ros"					
"Avenida de Hugo Bacharach"	"Avinguda de Hugo Bacharach"					
"Avenida del Parrissal"	"Avinguda del Parrissal"	"Avinguda del Parrissal"	"Avinguda del Parrissal"	""	""	""
"Avenida de Madrid"	"Avinguda de Madrid"	""	""	""	""	""
"Avenida Cortes de Aragón"	"Avinguda Cortes de Aragón"	""	""	""	""	""
"Avenida de la Hispanidad"	"Avinguda de la Hispanidad"	""	""	""	""	""
"Avenida Hispanidad"	"Avinguda Hispanidad"	""	""	""	""	""
"Avenida Virgen de Gracia"	"Avinguda Virgen de Gracia"	""	""	""	""	""
"Avenida de Aragón"	"Avinguda de Aragón"	""	""	"N-420"	"N-420"	"Q2282458"
"Avenida de Calaluña"	"Avinguda de Calaluña"	""	""	"N-420"	"N-420"	"Q2282458"
"Avenida del Cid"	"Avinguda del Cid"	""	""			
"Avenida Gola del Pujol"	"Avinguda Gola del Pujol"	""	""			
"Avenida de Antonio Muñoz"	"Avinguda de Antonio Muñoz"	""	""			
"Avenida Doctor Tomás Sala"	"Avinguda Doctor Tomás Sala"	"Bulevard Perifèric Sud"	"Bulevard Perifèric Sud"			
"Avenida Pío XII"	"Avinguda Pío XII"	""	""			
"Avenida Maria Cristina"	"Avinguda Maria Cristina"	""	""			
"Avenida de Vicente Blasco Ibáñez"	"Avinguda de Vicente Blasco Ibáñez"	""	""			
"Avenida María Quintana"	"Avinguda María Quintana"					
"Avenida de Mequinenza"	"Avinguda de Mequinenza"					
"Avenida Deportes"	"Avinguda Deportes"					
"Avenida Hondos"	"Avinguda Hondos"					
"Avenida Hermana Andresa Rafale"	"Avinguda Hermana Andresa Rafale"					
"Avenida de Cataluña"	"Avinguda de Cataluña"					
"Avenida les Corts Valencianes"	"Avinguda les Corts Valencianes"					
"Avenida de San Felipe"	"Avinguda de San Felipe"					
"Avenida las Moreras"	"Avinguda las Moreras"					
"Avenida Teniente General Federico Michavila"	"Avinguda Teniente General Federico Michavila"					
"Avenida de Fernando León"	"Avinguda de Fernando León"					
"Avenida de Caspe"	"Avinguda de Caspe"					
"Avenida de Pablo Gargallo"	"Avinguda de Pablo Gargallo"					
"Avenida de Orbe Cano"	"Avinguda de Orbe Cano"					
"Avenida Gabriel Covas Alemany"	"Avinguda Gabriel Covas Alemany"					
"Avenida de Peguera"	"Avinguda de Peguera"					
"Avenida Bendinat"	"Avinguda Bendinat"					
"Avenida del Mediterráneo (Mercadona)"	"Avinguda del Mediterráneo (Mercadona)"					
"Avenida de la Libertad - 33"	"Avinguda de la Libertad - 33"					
"Avenida de los Mártires"	"Avinguda de los Mártires"					
"Avenida Fuente en Segures"	"Avinguda Fuente en Segures"					
"Avenida de D. Ramón Valterra"	"Avinguda de D. Ramón Valterra"					
"Avenida de Enrique Monferrer"	"Avinguda de Enrique Monferrer"					
"Avenida Campo de Fútbol"	"Avinguda Campo de Fútbol"					
"Avenida de Florences Gil"	"Avinguda de Florences Gil"					
"Avenida San Vicente Paul"	"Avinguda San Vicente Paul"					
"Avenida Magnolia"	"Avinguda Magnolia"					
"Avenida Provensals"	"Avinguda Provensals"					
"avenida de Villena"	"avinguda de Villena"					
"Avenida Sierra la Villa"	"Avinguda Sierra la Villa"					
"Avenida Mestre J.Antonio Porto Valladares"	"Avinguda Mestre J.Antonio Porto Valladares"					
"Avenida San Medrdo"	"Avinguda San Medrdo"					
"Avenida Bonet"	"Avinguda Bonet"					
"Avenida Maestro Garí"	"Avinguda Maestro Garí"					
"Avenida de Vives Llull"	"Avinguda de Vives Llull"					
"Avenida Cuevas del Pilar"	"Avinguda Cuevas del Pilar"					
"Avenida Pintor Ramón Simarro Oltra"	"Avinguda Pintor Ramón Simarro Oltra"					
"Avenida Nou d'Octubre"	"Avinguda Nou d'Octubre"					
"Avenida Cortes de Aragón"	"Avinguda Cortes de Aragón"					
"Avenida Principe de España"	"Avinguda Principe de España"					
