"name"	"name:ca"	"alt_name:ca"	"alt_name"	"translations"	"ca.wikipedia_page"	"wikidata_type"	"wikidata_id"
"Camí Pau Redó - Hospital O Duran i Reynals"	"Camí Pau Redó - Hospital O Duran i Reynals"						
"Camí Pau Redó - Hospital O Duran i Reynals"	"Camí Pau Redó - Hospital O Duran i Reynals"		"Dani Infante"				
"Camí Pau Redó - Tanatori"	"Camí Pau Redó - Tanatori"						
"Avinguda Supermercats"	"Avinguda Supermercats"						
"Camí Pau Redó - Av Granvia"	"Camí Pau Redó - Av Granvia"						
"Parc de Bellvitge"	"Parc de Bellvitge"						
"Parc xe Bellvitge"	"Parc xe Bellvitge"						
"Parc de les Planes"	"Parc de les Planes"						
"Avinguda del Masnou"	"Avinguda del Masnou"						
"Avinguda Josep Molins"	"Avinguda Josep Molins"						
"Carrer de Francesc Moragas"	"Carrer de Francesc Moragas"						
"Carrer de Femades"	"Carrer de Femades"						
"Carrer del Crom"	"Carrer del Crom"						
"Camí de la Cadena"	"Camí de la Cadena"						
"Carrer d'Arquimedes"	"Carrer d'Arquimedes"						
"Carrer de Frederic Prats"	"Carrer de Frederic Prats"						
"Carrer de Joan N. García-Nieto"	"Carrer de Joan N. García-Nieto"						
"Avinguda de Ramon Frontera"	"Avinguda de Ramon Frontera"						
"Carrer de Miquel Peiró i Victori"	"Carrer de Miquel Peiró i Victori"						
"Carrer del Pare Marchena"	"Carrer del Pare Marchena"						
"Carrer de Bellavista"	"Carrer de Bellavista"						
"Carrer del Xipreret"	"Carrer del Xipreret"						
"Carrer de Sant Joan"	"Carrer de Sant Joan"						
"Carrer de la Reforma"	"Carrer de la Reforma"						
"Carrer de la Talaia"	"Carrer de la Talaia"						
"Plaça de la Remunta"	"Plaça de la Remunta"						
"Carrer de la Riera de l'Escorxador"	"Carrer de la Riera de l'Escorxador"						
"Carrer Xipreret"	"Carrer Xipreret"						
"Parc de la Remunta"	"Parc de la Remunta"						
"Carrer de Josep Irla i Bosch"	"Carrer de Josep Irla i Bosch"						
"Carrer de Josep Muntané i Almirall"	"Carrer de Josep Muntané i Almirall"						
"Avinguda de Josep Tarradellas i Joan"	"Avinguda de Josep Tarradellas i Joan"						
"Carrer de Digoine"	"Carrer de Digoine"						
"Carrer de Carles Martí Feced"	"Carrer de Carles Martí Feced"						
"Carrer de Barcelona"	"Carrer de Barcelona"						
"Carrer de Sanfeliu"	"Carrer de Sanfeliu"						
"Carrer de l'Estronci"	"Carrer de l'Estronci"						
"Carrer del Rubidi"	"Carrer del Rubidi"						
"Carrer Major"	"Carrer Major"						
"Carrer de Josep Maria de Sagarra"	"Carrer de Josep Maria de Sagarra"						
"Carrer de Molines"	"Carrer de Molines"						
"Carrer de la Riera del Canyet"	"Carrer de la Riera del Canyet"						
"Camí del Torrent de Can Nyac"	"Camí del Torrent de Can Nyac"						
"Carrer de Josep Prats"	"Carrer de Josep Prats"						
"Camí d'Esplugues"	"Camí d'Esplugues"						
"Carrer de Provença"	"Carrer de Provença"						
"Camí de la Fonteta"	"Camí de la Fonteta"						
"Carrer de Valeta"	"Carrer de Valeta"						
"Carrer de Cornellà"	"Carrer de Cornellà"						
"Carrer de la Miralta"	"Carrer de la Miralta"						
"Carrer de l'Emigrant"	"Carrer de l'Emigrant"						
"Carrer de Llunàs"	"Carrer de Llunàs"						
"Carrer de Pompeu Fabra"	"Carrer de Pompeu Fabra"						
"Avinguda de l'Electricitat"	"Avinguda de l'Electricitat"						
"Plaça de la Llosa"	"Plaça de la Llosa"						
"Plaça de les Comunitats"	"Plaça de les Comunitats"						
"Plaça dels Cirerers"	"Plaça dels Cirerers"						
"Carrer del Rei En Jaume"	"Carrer del Rei En Jaume"						
"Carrer del Tel·luri"	"Carrer del Tel·luri"						
"Carrer del Poeta Llombart"	"Carrer del Poeta Llombart"						
"Carrer Alt"	"Carrer Alt"						
"Carrer de Bernini"	"Carrer de Bernini"						
"Carrer de Lleó"	"Carrer de Lleó"						
"Carrer de l'Ametller"	"Carrer de l'Ametller"						
"Carrer de l'Aviació"	"Carrer de l'Aviació"						
"Carrer de la Feixa Llarga"	"Carrer de la Feixa Llarga"						
"Carrer Número 43"	"Carrer Número 43"						
"Camí de Cal Joan del Ros"	"Camí de Cal Joan del Ros"						
"Camí de Cal Pau Redó"	"Camí de Cal Pau Redó"						
"Carrer Número 3"	"Carrer Número 3"						
"Carrer de la Residència"	"Carrer de la Residència"						
"Carrer de l'Ermita de Bellvitge"	"Carrer de l'Ermita de Bellvitge"						
"Avinguda de la Mare de Déu de Bellvitge"	"Avinguda de la Mare de Déu de Bellvitge"						
"Carrer de la Residència"	"Carrer de la Residència"						
"Carrer de Jaume Ventura i Tort"	"Carrer de Jaume Ventura i Tort"						
"Carrer del Prat"	"Carrer del Prat"						
"Carrer de Santa Rosa"	"Carrer de Santa Rosa"						
"Carrer de Roca i Umbert"	"Carrer de Roca i Umbert"						
"Avinguda del Carrilet"	"Avinguda del Carrilet"						
"Avinguda de la Fabregada"	"Avinguda de la Fabregada"						
"Carrer de l'Ermita de Bellvitge"	"Carrer de l'Ermita de Bellvitge"						
"Avinguda de Pau Casals"	"Avinguda de Pau Casals"						
"Carrer del Cobalt"	"Carrer del Cobalt"						
"Carrer de Portugal"	"Carrer de Portugal"						
"Camí de la Riereta"	"Camí de la Riereta"						
"Carrer del Níquel"	"Carrer del Níquel"						
"Carrer de Sant Roc"	"Carrer de Sant Roc"						
"Carrer de Vilardosa"	"Carrer de Vilardosa"						
"Avinguda Mare de Deu de Bellvitge"	"Avinguda Mare de Deu de Bellvitge"						
"Plaça d'Amalvígia"	"Plaça d'Amalvígia"						
"Carrer de les Ciències"	"Carrer de les Ciències"						
"Carrer dels Motors"	"Carrer dels Motors"						
"Carrer de Rafael Barradas"	"Carrer de Rafael Barradas"						
"Avinguda de Vilanova"	"Avinguda de Vilanova"						
"Carrer de la Botànica"	"Carrer de la Botànica"						
"Carrer del Primer de Maig"	"Carrer del Primer de Maig"						
"Carrer de Montserrat Roig"	"Carrer de Montserrat Roig"						
"Carrer d'Herrero"	"Carrer d'Herrero"						
"Carrer de José Agustín Goytisolo"	"Carrer de José Agustín Goytisolo"						
"Carrer de Salvador Espriu"	"Carrer de Salvador Espriu"						
"Avinguda de la Granvia de l'Hospitalet"	"Avinguda de la Granvia de l'Hospitalet"						
"Carrer de Can Pi"	"Carrer de Can Pi"						
"Carrer de Pablo Iglesias"	"Carrer de Pablo Iglesias"						
"Carrer de les Sangoneres"	"Carrer de les Sangoneres"						
"Carrer de Miguel Hernández"	"Carrer de Miguel Hernández"						
"Carrer de Can Trias"	"Carrer de Can Trias"						
"Carrer de Campoamor"	"Carrer de Campoamor"						
"Plaça d'Europa"	"Plaça d'Europa"						
"Carrer de França"	"Carrer de França"						
"Plaça de la Cultura"	"Plaça de la Cultura"						
"Parc de la Granvia de l'Hospitalet"	"Parc de la Granvia de l'Hospitalet"						
"Avinguda de la Gran Via de l'Hospitalet"	"Avinguda de la Gran Via de l'Hospitalet"						
"Avinguda de la Gra Via"	"Avinguda de la Gra Via"						
"Carrer Botànica"	"Carrer Botànica"						
"Carrer Salvador Espriu"	"Carrer Salvador Espriu"						
"Avinguda de Joan Carles I"	"Avinguda de Joan Carles I"						
"Carrer Pedrosa A"	"Carrer Pedrosa A"						
"Carrer de Dolors Aleu"	"Carrer de Dolors Aleu"						
"Carrer del Foc"	"Carrer del Foc"						
"Carrer de la Metal·lúrgia"	"Carrer de la Metal·lúrgia"						
"Carrer d'Espanya"	"Carrer d'Espanya"						
"Carrer de l'Església"	"Carrer de l'Església"						
"Carrer de Mossèn Santiago Oliveras"	"Carrer de Mossèn Santiago Oliveras"						
"Carrer de Tarragona"	"Carrer de Tarragona"						
"Carrer del Ter"	"Carrer del Ter"						
"Carrer de Vigo"	"Carrer de Vigo"						
"Carrer de Montserrat"	"Carrer de Montserrat"						
"Carrer de Mossèn Lluís Pañella"	"Carrer de Mossèn Lluís Pañella"						
"Carrer de la Riera de la Creu"	"Carrer de la Riera de la Creu"						
"Carrer del Centre"	"Carrer del Centre"						
"Carrer de Tecla Sala"	"Carrer de Tecla Sala"						
"Carrer del Mercat"	"Carrer del Mercat"						
"Plaça de la Mare de Déu de Montserrat"	"Plaça de la Mare de Déu de Montserrat"						
"Carrer Santa Bàrbara"	"Carrer Santa Bàrbara"						
"Carrer de Santa Bàrbara"	"Carrer de Santa Bàrbara"						
"Plaça de l'Ajuntament"	"Plaça de l'Ajuntament"						
"Carrer de les Roselles"	"Carrer de les Roselles"						
"Carrer Tarragona"	"Carrer Tarragona"						
"Carrer de Joan Pallarès"	"Carrer de Joan Pallarès"						
"Carrer del Baró de Maldà"	"Carrer del Baró de Maldà"						
"Carrer de Santa Anna"	"Carrer de Santa Anna"						
"Plaça de Mossèn Homar"	"Plaça de Mossèn Homar"						
"Carrer de Rossend Arús"	"Carrer de Rossend Arús"						
"Plaça del Repartidor"	"Plaça del Repartidor"						
"Plaça de Josep Bordonau i Balaguer"	"Plaça de Josep Bordonau i Balaguer"						
"Plaça de la Constitució"	"Plaça de la Constitució"						
"Carrer d'Enric Prat de la Riba"	"Carrer d'Enric Prat de la Riba"						
"Carrer del Príncep de Bergara"	"Carrer del Príncep de Bergara"						
"Carrer de les Esquadres"	"Carrer de les Esquadres"						
"Carrer de Santiago de Compostel·la"	"Carrer de Santiago de Compostel·la"						
"Carrer de Vic"	"Carrer de Vic"						
"Carrer de la Riera dels Frares"	"Carrer de la Riera dels Frares"						
"Carrer del Migdia"	"Carrer del Migdia"						
"Carrer de Los Castillejos"	"Carrer de Los Castillejos"						
"Carrer Sant Antoni"	"Carrer Sant Antoni"						
"Carrer de les Arts i els Oficis"	"Carrer de les Arts i els Oficis"						
"Carrer de Vilumara"	"Carrer de Vilumara"						
"Plaça del Mestre Clavé"	"Plaça del Mestre Clavé"						
"Carrer del Mestre Candi"	"Carrer del Mestre Candi"						
"Carrer de Rodés"	"Carrer de Rodés"						
"Carrer de Segòvia"	"Carrer de Segòvia"						
"Parc de la Serp"	"Parc de la Serp"						
"Plaça de Puig i Gairalt"	"Plaça de Puig i Gairalt"						
"Carrer de Josep Pla"	"Carrer de Josep Pla"						
"Carrer de Saurí"	"Carrer de Saurí"						
"Carrer de Sant Antoni"	"Carrer de Sant Antoni"						
"Carrer d'Ángeles Santos"	"Carrer d'Ángeles Santos"						
"Carrer de Maria Miret"	"Carrer de Maria Miret"						
"Carrer de Rosa Crexells"	"Carrer de Rosa Crexells"						
"Carrer del Molí"	"Carrer del Molí"						
"Carrer de les Bòbiles"	"Carrer de les Bòbiles"						
"Carrer de Sant Josep"	"Carrer de Sant Josep"						
"Carrer de la Muntanya"	"Carrer de la Muntanya"						
"Carrer de Joan Maragall"	"Carrer de Joan Maragall"						
"Avinguda de Ventura Gassol"	"Avinguda de Ventura Gassol"						
"Carrer de la Rosa d'Alexandria"	"Carrer de la Rosa d'Alexandria"						
"Carrer d'Andorra"	"Carrer d'Andorra"						
"Carrer del Pintor Mestre i Castellví"	"Carrer del Pintor Mestre i Castellví"						
"Carrer de Girona"	"Carrer de Girona"						
"Avinguda de Catalunya"	"Avinguda de Catalunya"						
"Carrer de Ceravalls"	"Carrer de Ceravalls"						
"Carrer del Teide"	"Carrer del Teide"						
"Carrer del Llorer"	"Carrer del Llorer"						
"Carrer de la Libèl·lula"	"Carrer de la Libèl·lula"						
"Plaça dels Blocs de la Florida"	"Plaça dels Blocs de la Florida"						
"Carrer de la Renclusa"	"Carrer de la Renclusa"						
"Carrer de Subur"	"Carrer de Subur"						
"Avinguda de la Primavera"	"Avinguda de la Primavera"						
"Carrer dels Pins"	"Carrer dels Pins"						
"Avinguda de Vilafranca"	"Avinguda de Vilafranca"						
"Carrer de Casanova"	"Carrer de Casanova"						
"Carrer de l'Estrella"	"Carrer de l'Estrella"						
"Carrer de Miquel Romeu"	"Carrer de Miquel Romeu"						
"Carrer del Bruc"	"Carrer del Bruc"						
"Plaça de Lluís Companys i Jover"	"Plaça de Lluís Companys i Jover"						
"Carrer dels Clavells"	"Carrer dels Clavells"						
"Carrer de Peníscola"	"Carrer de Peníscola"						
"Carrer de la Hierbabuena"	"Carrer de la Hierbabuena"						
"Parc de Can Creixells"	"Parc de Can Creixells"						
"Parc de Can Cluset"	"Parc de Can Cluset"						
"Avinguda de Miraflors"	"Avinguda de Miraflors"						
"Carrer de la Florida"	"Carrer de la Florida"						
"Carrer del Parral"	"Carrer del Parral"						
"Carrer de Sant Rafael"	"Carrer de Sant Rafael"						
"Carrer de Sant Pere"	"Carrer de Sant Pere"						
"Carrer de la Carpa"	"Carrer de la Carpa"						
"Carrer de Faus"	"Carrer de Faus"						
"Carrer de Màlaga"	"Carrer de Màlaga"						
"Carrer de Pere Pelegrí"	"Carrer de Pere Pelegrí"						
"Carrer de Badajoz"	"Carrer de Badajoz"						
"Carrer de Granollers"	"Carrer de Granollers"						
"Carrer de Castellbò"	"Carrer de Castellbò"						
"Carrer Oriental"	"Carrer Oriental"						
"Carrer de la Bisbal"	"Carrer de la Bisbal"						
"Carrer de Sant Carles"	"Carrer de Sant Carles"						
"Plaça de la Font"	"Plaça de la Font"						
"Plaça de la Casa de la Reconciliació"	"Plaça de la Casa de la Reconciliació"						
"Plaça de la Carpa"	"Plaça de la Carpa"						
"Carrer de Sant Francesc Xavier"	"Carrer de Sant Francesc Xavier"						
"Carrer de l'Abedul"	"Carrer de l'Abedul"						
"Carrer de Menorca"	"Carrer de Menorca"						
"Carrer de l'Esmaragda"	"Carrer de l'Esmaragda"						
"Carrer de l'Ebre"	"Carrer de l'Ebre"						
"Carrer del Radi"	"Carrer del Radi"						
"Carrer de Juan de Toledo"	"Carrer de Juan de Toledo"						
"Carrer de Menéndez Pidal"	"Carrer de Menéndez Pidal"						
"Plaça de Tuzla"	"Plaça de Tuzla"						
"Carrer d'Almadén"	"Carrer d'Almadén"						
"Carrer de Galvani"	"Carrer de Galvani"						
"Carrer de Sant Ramon"	"Carrer de Sant Ramon"						
"Carrer de les Illes Canàries"	"Carrer de les Illes Canàries"						
"Carrer de Leonardo da Vinci"	"Carrer de Leonardo da Vinci"						
"Carrer de Rosalía de Castro"	"Carrer de Rosalía de Castro"						
"Carrer de Caterina Albert"	"Carrer de Caterina Albert"						
"Carrer de Sant Eugeni"	"Carrer de Sant Eugeni"						
"Carrer Rosalía de Castro"	"Carrer Rosalía de Castro"						
"Carrer de Juan Ramón Jiménez"	"Carrer de Juan Ramón Jiménez"						
"Carrer de Colom"	"Carrer de Colom"						
"Carrer de l'Aprestadora"	"Carrer de l'Aprestadora"						
"Carrer dels Joncs"	"Carrer dels Joncs"						
"Carrer de la Fortuna"	"Carrer de la Fortuna"						
"Carrer de Joan de Joane"	"Carrer de Joan de Joane"						
"Carrer de Joan de Joanes"	"Carrer de Joan de Joanes"						
"Plaça de Quart"	"Plaça de Quart"						
"Carrer de Badalona"	"Carrer de Badalona"						
"Carrer del Progrés"	"Carrer del Progrés"						
"Carrer de Llançà"	"Carrer de Llançà"						
"Carrer de Mas"	"Carrer de Mas"						
"Carrer de Vallparda"	"Carrer de Vallparda"						
"Carrer de l'Alegria"	"Carrer de l'Alegria"						
"Carrer de Castelao"	"Carrer de Castelao"						
"Carrer de Martí i Blasi"	"Carrer de Martí i Blasi"						
"Carrer de Jerusalem"	"Carrer de Jerusalem"						
"Carrer de Ferrer i Guàrdia"	"Carrer de Ferrer i Guàrdia"						
"Carrer de Pi i Margall"	"Carrer de Pi i Margall"						
"Carrer de Lavínia"	"Carrer de Lavínia"						
"Carrer de Santa Eulàlia"	"Carrer de Santa Eulàlia"						
"Carrer de Santiago Apòstol"	"Carrer de Santiago Apòstol"						
"Carrer de Narcís Monturiol"	"Carrer de Narcís Monturiol"						
"Carrer de Sant Pius X"	"Carrer de Sant Pius X"						
"Avinguda del Torrent Gornal"	"Avinguda del Torrent Gornal"						
"Carrer del Montseny"	"Carrer del Montseny"						
"Carrer de la Mare de Déu dels Desemparats"	"Carrer de la Mare de Déu dels Desemparats"						
"Carrer de Mossèn Jaume Busquet"	"Carrer de Mossèn Jaume Busquet"						
"Plaça de Blas Infante"	"Plaça de Blas Infante"						
"Carrer del Pintor Sorolla"	"Carrer del Pintor Sorolla"						
"Carrer de Ca n'Alòs"	"Carrer de Ca n'Alòs"						
"Carrer del Treball"	"Carrer del Treball"						
"Carrer de Cortada"	"Carrer de Cortada"						
"Carrer de les Muses"	"Carrer de les Muses"						
"Carrer de la Joventut"	"Carrer de la Joventut"						
"Plaça de Sant Jordi"	"Plaça de Sant Jordi"						
"Carrer de la Mare de Déu de la Mercè"	"Carrer de la Mare de Déu de la Mercè"						
"Carrer de Pau Sans"	"Carrer de Pau Sans"						
"Carrer de la Ciutat Comtal"	"Carrer de la Ciutat Comtal"						
"Carrer de Joan XXIII"	"Carrer de Joan XXIII"						
"Plaça de les Palmeres"	"Plaça de les Palmeres"						
"Carrer del Doctor Martí i Julià"	"Carrer del Doctor Martí i Julià"						
"Carrer de Clara Campoamor"	"Carrer de Clara Campoamor"						
"Plaça de Frederica Montseny"	"Plaça de Frederica Montseny"						
"Carrer del Llobregat"	"Carrer del Llobregat"						
"Carrer de Jansana"	"Carrer de Jansana"						
"Carrer de Rosell"	"Carrer de Rosell"						
"Carrer del Garraf"	"Carrer del Garraf"						
"Carrer del Canigó"	"Carrer del Canigó"						
"Carrer de Terra Baixa"	"Carrer de Terra Baixa"						
"Carrer de Batllori"	"Carrer de Batllori"						
"Carrer de Plini"	"Carrer de Plini"						
"Parc de la Cabana"	"Parc de la Cabana"						
"Carrer de Granada"	"Carrer de Granada"						
"Avinguda de Ponent"	"Avinguda de Ponent"						
"Avinguda del Nord"	"Avinguda del Nord"						
"Carrer de les Mimoses"	"Carrer de les Mimoses"						
"Carrer d'Almeria"	"Carrer d'Almeria"						
"Plaça de Granada"	"Plaça de Granada"	"Plaça dels Escacs"	"Plaça dels Escacs"				
"Parc de la Pau"	"Parc de la Pau"						
"Carrer de la Primavera"	"Carrer de la Primavera"						
"Carrer dels Garrofers"	"Carrer dels Garrofers"						
"Carrer del Clotet"	"Carrer del Clotet"						
"Carrer del Gasòmetre"	"Carrer del Gasòmetre"						
"Carrer de la Cooperativa"	"Carrer de la Cooperativa"						
"Carrer d'Albareda"	"Carrer d'Albareda"						
"Carrer del Doctor Gregorio Marañón"	"Carrer del Doctor Gregorio Marañón"						
"Carrer de la Cultura"	"Carrer de la Cultura"						
"Carrer de Gonçal Pons"	"Carrer de Gonçal Pons"						
"Carrer de l'Amistat"	"Carrer de l'Amistat"						
"Carrer de Corominas"	"Carrer de Corominas"						
"Carrer del Transformador"	"Carrer del Transformador"						
"Carrer de Terrè"	"Carrer de Terrè"						
"Carrer de Ponsich"	"Carrer de Ponsich"						
"Carrer d'Albareda"	"Carrer d'Albareda"	"Carrer de l'Albereda"	"Carrer de l'Albereda"				
"Parc de la Torrassa"	"Parc de la Torrassa"						
"Carrer de Justa Goicoechea"	"Carrer de Justa Goicoechea"						
"Carrer del Patronat"	"Carrer del Patronat"						
"Carrer de la Glòria"	"Carrer de la Glòria"						
"Carrer de Carrasco i Formiguera"	"Carrer de Carrasco i Formiguera"						
"Plaça de l'UNICEF"	"Plaça de l'UNICEF"						
"Carrer de Salamina"	"Carrer de Salamina"						
"Carrer de Can Pujadas"	"Carrer de Can Pujadas"						
"Plaça de Provençana"	"Plaça de Provençana"						
"Plaça de Can Trinxet"	"Plaça de Can Trinxet"						
"Carrer de la Pubilla Cases"	"Carrer de la Pubilla Cases"						
"Carrer de Toledo"	"Carrer de Toledo"						
"Carrer d'Oviedo"	"Carrer d'Oviedo"						
"Carrer de Belchite"	"Carrer de Belchite"						
"Carrer dels Naranjos"	"Carrer dels Naranjos"						
"Carrer de Calderón de la Barca"	"Carrer de Calderón de la Barca"						
"Carrer de Covadonga"	"Carrer de Covadonga"						
"Plaça de l'Alzina"	"Plaça de l'Alzina"						
"Avinguda del Bosc"	"Avinguda del Bosc"						
"Carrer de les Amapolas"	"Carrer de les Amapolas"						
"Avinguda de Severo Ochoa"	"Avinguda de Severo Ochoa"						
"Carrer de les Roses"	"Carrer de les Roses"						
"Carrer de Simancas"	"Carrer de Simancas"						
"Carrer de Vinaròs"	"Carrer de Vinaròs"						
"Carrer de la Mina"	"Carrer de la Mina"						
"Carrer de la Maladeta"	"Carrer de la Maladeta"						
"Carrer d'Amadeu Vives"	"Carrer d'Amadeu Vives"						
"Avinguda del Torrent"	"Avinguda del Torrent"						
"Plaça de la Bòbila"	"Plaça de la Bòbila"						
"Carrer de Marcel·lí Esquius"	"Carrer de Marcel·lí Esquius"						
"Carrer de Finestrelles"	"Carrer de Finestrelles"						
"Carrer d'Esteve Grau"	"Carrer d'Esteve Grau"						
"Carrer d'Òrrius"	"Carrer d'Òrrius"						
"Carrer d'El Empecinado"	"Carrer d'El Empecinado"						
"Carrer del Mont-ras"	"Carrer del Mont-ras"						
"Carrer de l'El·lipse"	"Carrer de l'El·lipse"						
"Carrer del General Manso"	"Carrer del General Manso"						
"Carrer del Mestre Serrano"	"Carrer del Mestre Serrano"						
"Carrer d'Albéniz"	"Carrer d'Albéniz"						
"Avinguda de Tomás Giménez"	"Avinguda de Tomás Giménez"						
"Carrer de l'Empordà"	"Carrer de l'Empordà"						
"Avinguda de Josep Molins"	"Avinguda de Josep Molins"						
"Carrer d'Empúries"	"Carrer d'Empúries"						
"Plaça de la Pubilla Cases"	"Plaça de la Pubilla Cases"						
"Carrer de Josep Sunyol i Garriga"	"Carrer de Josep Sunyol i Garriga"						
"Carrer de les Aigües del Llobregat"	"Carrer de les Aigües del Llobregat"						
"Carrer de Numància"	"Carrer de Numància"						
"Carrer de Diògenes"	"Carrer de Diògenes"						
"Carrer d'Ibèria"	"Carrer d'Ibèria"						
"Avinguda de Miraflores"	"Avinguda de Miraflores"						
"Plaça de la Mare de Déu del Pilar"	"Plaça de la Mare de Déu del Pilar"						
"Avinguda del Doctor Ramon Solanich i Riera"	"Avinguda del Doctor Ramon Solanich i Riera"						
"Carrer Pedraforca"	"Carrer Pedraforca"						
"Carrer de Llevant"	"Carrer de Llevant"						
"Carrer del Pedraforca"	"Carrer del Pedraforca"						
"Carrer de Castellvell"	"Carrer de Castellvell"						
"Carrer de Sevilla"	"Carrer de Sevilla"						
"Plaça d'Eivissa"	"Plaça d'Eivissa"						
"Carrer de l'Antiga Travessera"	"Carrer de l'Antiga Travessera"						
"Carrer de Cervantes"	"Carrer de Cervantes"						
"Carrer de Collserola"	"Carrer de Collserola"						
"Carrer de la Mare de Déu de la Llum"	"Carrer de la Mare de Déu de la Llum"						
"Plaça de la Llibertat"	"Plaça de la Llibertat"						
"Plaça de Federico García Lorca"	"Plaça de Federico García Lorca"						
"Carrer de l'Enginyer Moncunill"	"Carrer de l'Enginyer Moncunill"						
"Carrer de Piera"	"Carrer de Piera"						
"Carrer de Floridablanca"	"Carrer de Floridablanca"						
"Carrer de Luarca"	"Carrer de Luarca"						
"Carrer de Font"	"Carrer de Font"						
"Avinguda de Manuel Azaña"	"Avinguda de Manuel Azaña"						
"Carrer de Gravina"	"Carrer de Gravina"						
"Carrer de la Mare de Déu de Puigcerver"	"Carrer de la Mare de Déu de Puigcerver"						
"Carrer de Carles Ferrer Salat"	"Carrer de Carles Ferrer Salat"						
"Carrer de Pujós"	"Carrer de Pujós"						
"Carrer del Mont"	"Carrer del Mont"						
"Carrer de Graner"	"Carrer de Graner"						
"Carrer de Rius i Carrió"	"Carrer de Rius i Carrió"						
"Carrer del Cinca"	"Carrer del Cinca"						
"Carrer d'Albiol"	"Carrer d'Albiol"						
"Carrer de Cotonat"	"Carrer de Cotonat"						
"Carrer del Dos de Maig"	"Carrer del Dos de Maig"						
"Carrer de Sort"	"Carrer de Sort"						
"Carrer de Mercader"	"Carrer de Mercader"						
"Carrer del Jardí"	"Carrer del Jardí"						
"Carrer de l'Atlàntida"	"Carrer de l'Atlàntida"						
"Carrer de Ferré"	"Carrer de Ferré"						
"Carrer de la Mare de Déu de Núria"	"Carrer de la Mare de Déu de Núria"						
"Parc dels Ocellets"	"Parc dels Ocellets"						
"Carrer de Rosich"	"Carrer de Rosich"						
"Camí de la Torre Melina"	"Camí de la Torre Melina"						
"Carrer d'Alacant"	"Carrer d'Alacant"						
"Carrer de Mistral"	"Carrer de Mistral"						
"Carrer de la Creu Roja"	"Carrer de la Creu Roja"						
"Carrer de la Vinyeta"	"Carrer de la Vinyeta"						
"Plaça del Cadí"	"Plaça del Cadí"						
"Carrer de l'Estudi"	"Carrer de l'Estudi"						
"Carrer d'Ernest Lluch"	"Carrer d'Ernest Lluch"						
"Plaça d'Ernest Lluch"	"Plaça d'Ernest Lluch"						
"Carrer d'Antonio Machado"	"Carrer d'Antonio Machado"						
"Plaça de Canalejas"	"Plaça de Canalejas"						
"Carrer de Felip Pedrell"	"Carrer de Felip Pedrell"						
"Carrer de la Terra Alta"	"Carrer de la Terra Alta"						
"Carrer de Claret"	"Carrer de Claret"						
"Carrer de Salvador Seguí"	"Carrer de Salvador Seguí"						
"Carrer de Rafael Campalans"	"Carrer de Rafael Campalans"						
"Carrer d'Orient"	"Carrer d'Orient"						
"Carrer de París"	"Carrer de París"						
"Carrer de Besa"	"Carrer de Besa"						
"Carrer d'Estruch"	"Carrer d'Estruch"						
"Carrer de Goya"	"Carrer de Goya"						
"Carrer de Fortuny"	"Carrer de Fortuny"						
"Carrer d'Occident"	"Carrer d'Occident"						
"Carrer del Doctor Jaume Ferran i Clua"	"Carrer del Doctor Jaume Ferran i Clua"						
"Carrer de Vaquer"	"Carrer de Vaquer"						
"Carrer de Martorell"	"Carrer de Martorell"						
"Plaça del Mercat de Collblanc"	"Plaça del Mercat de Collblanc"						
"Carrer de Rabarté"	"Carrer de Rabarté"						
"Plaça de les Vidrieries Llobregat"	"Plaça de les Vidrieries Llobregat"						
"Carrer de la Riera Blanca"	"Carrer de la Riera Blanca"						
"Plaça de Guernica"	"Plaça de Guernica"						
"Carrer de Llavinés"	"Carrer de Llavinés"						
"Carrer de Farnés"	"Carrer de Farnés"						
"Carrer de Torns"	"Carrer de Torns"						
"Parc de la Marquesa"	"Parc de la Marquesa"						
"Plaça dels Pirineus"	"Plaça dels Pirineus"						
"Plaça de les Germanes Ocaña"	"Plaça de les Germanes Ocaña"						
"Carrer de Pérez Galdós"	"Carrer de Pérez Galdós"						
"Plaça de la Solidaritat"	"Plaça de la Solidaritat"						
"Carrer de Francesc Layret"	"Carrer de Francesc Layret"						
"Carrer de l'Onze de Setembre"	"Carrer de l'Onze de Setembre"						
"Carrer de la Igualtat"	"Carrer de la Igualtat"						
"Carrer del Prat de la Manta"	"Carrer del Prat de la Manta"						
"Carrer de Blas Fernández Lirola"	"Carrer de Blas Fernández Lirola"						
"Carrer de Natzaret"	"Carrer de Natzaret"						
"Carrer de la Independència"	"Carrer de la Independència"						
"Carrer de la Física"	"Carrer de la Física"						
"Plaça de Marie Curie"	"Plaça de Marie Curie"						
"Plaça de Lola Anglada"	"Plaça de Lola Anglada"						
"Carrer de Bacardí"	"Carrer de Bacardí"						
"Carrer de l'Arquitectura"	"Carrer de l'Arquitectura"						
"Carrer de la Literatura"	"Carrer de la Literatura"						
"Carrer de Mileva Maric"	"Carrer de Mileva Maric"						
"Carrer de Hannah Arendt"	"Carrer de Hannah Arendt"						
"Carrer de Victoria Kent"	"Carrer de Victoria Kent"						
"Plaça del Repòs"	"Plaça del Repòs"						
"Plaça dels Veïns"	"Plaça dels Veïns"						
"Carrer de l'Alumini"	"Carrer de l'Alumini"						
"Carrer de Buenos Aires"	"Carrer de Buenos Aires"						
"Carrer Transversal"	"Carrer Transversal"						
"Carrer de l'Uva"	"Carrer de l'Uva"						
"Carrer d'Àngel Guimerà"	"Carrer d'Àngel Guimerà"						
"Carrer del Comerç"	"Carrer del Comerç"						
"Carrer del General Prim"	"Carrer del General Prim"						
"Carrer Modern"	"Carrer Modern"						
"Carrer de l'Alhambra"	"Carrer de l'Alhambra"						
"Carrer de Martí-Codolar"	"Carrer de Martí-Codolar"						
"Carrer de Santiago Ramón y Cajal"	"Carrer de Santiago Ramón y Cajal"						
"Carrer d'Holanda"	"Carrer d'Holanda"						
"Parc de l'Alhambra"	"Parc de l'Alhambra"						
"Carrer de la Unió"	"Carrer de la Unió"						
"Plaça de Milagros Consarnau i Sabaté"	"Plaça de Milagros Consarnau i Sabaté"						
"Plaça de Vidre"	"Plaça de Vidre"						
"Plaça de Joan Brossa"	"Plaça de Joan Brossa"						
"Carrer d'Anselm Clavé"	"Carrer d'Anselm Clavé"						
"Carrer de Pareto"	"Carrer de Pareto"						
"Carrer de Salvador"	"Carrer de Salvador"						
"Carrer de Maluquer"	"Carrer de Maluquer"						
"Carrer de Muns"	"Carrer de Muns"						
"Carrer de Santiago Rusiñol"	"Carrer de Santiago Rusiñol"						
"Carrer del Doctor Fleming"	"Carrer del Doctor Fleming"						
"Plaça de Francesc Macià i Llussà"	"Plaça de Francesc Macià i Llussà"						
"Carrer del Mestre Carbó"	"Carrer del Mestre Carbó"						
"Avinguda del Metro"	"Avinguda del Metro"						
"Carrer del Cavall Bernat"	"Carrer del Cavall Bernat"						
"Carrer d'Isaac Peral"	"Carrer d'Isaac Peral"						
"Carrer de Rafael de Campalans"	"Carrer de Rafael de Campalans"						
"Carrer de Jacint Verdaguer"	"Carrer de Jacint Verdaguer"						
"Plaça dels Avis"	"Plaça dels Avis"						
"Plaça de Camilo José Cela"	"Plaça de Camilo José Cela"						
"Plaça de Pius XII"	"Plaça de Pius XII"						
"Plaça de Maria Artigal"	"Plaça de Maria Artigal"						
"Plaça de l'Hortet"	"Plaça de l'Hortet"						
"Plaça de l'Escorsa"	"Plaça de l'Escorsa"						
"Plaça de Can Colom"	"Plaça de Can Colom"						
"Plaça de Maria Aurèlia Capmany"	"Plaça de Maria Aurèlia Capmany"						
"Plaça de Maria Soteras"	"Plaça de Maria Soteras"						
"Plaça de Sant Isidre"	"Plaça de Sant Isidre"						
"Carrer del Rosselló"	"Carrer del Rosselló"						
"Carrer del Congost"	"Carrer del Congost"						
"Plaça de l'Estació - Passatge Bertrand"	"Plaça de l'Estació - Passatge Bertrand"						
"Parc del Llobregat"	"Parc del Llobregat"						
"Parc Esportiu Les Grases"	"Parc Esportiu Les Grases"						
"Parc Europa"	"Parc Europa"						
"Carrer del Pla"	"Carrer del Pla"						
"Carrer de Joaquim Castells"	"Carrer de Joaquim Castells"						
"Carrer de Rupert Lladó"	"Carrer de Rupert Lladó"						
"Carrer de Joan Batllori"	"Carrer de Joan Batllori"						
"Carrer de Pi i Margall"	"Carrer de Pi i Margall"						
"Carrer de Miguel de Cervantes"	"Carrer de Miguel de Cervantes"						
"Carrer de Josep María de Molina"	"Carrer de Josep María de Molina"						
"Carrer de Pere Álvarez"	"Carrer de Pere Álvarez"						
"Carrer de la Riera d'en Pahissa"	"Carrer de la Riera d'en Pahissa"						
"Carrer del Primer de Maig"	"Carrer del Primer de Maig"						
"Carrer de Sant Josep"	"Carrer de Sant Josep"						
"Carrer de les Creus"	"Carrer de les Creus"						
"Carrer de Laureà Miró"	"Carrer de Laureà Miró"						
"Parc Vuit de Març"	"Parc Vuit de Març"						
"Carrer Jaume Ribas"	"Carrer Jaume Ribas"						
"Carrer de Santa Maria"	"Carrer de Santa Maria"						
"Carrer Verge de les Neus"	"Carrer Verge de les Neus"						
"Carrer de Sant Joan"	"Carrer de Sant Joan"						
"Carrer de Sant Antoni"	"Carrer de Sant Antoni"						
"Carrer Doctor Barraquer"	"Carrer Doctor Barraquer"						
"Carrer de Josep Maria de Segarra"	"Carrer de Josep Maria de Segarra"						
"Carrer Falguera"	"Carrer Falguera"						
"Carrer Joan Antoni Samaranch"	"Carrer Joan Antoni Samaranch"						
"Plaça de Rafael Alberti"	"Plaça de Rafael Alberti"						
"Carrer Remigio Guix"	"Carrer Remigio Guix"						
"Carrer de Ramón y Cajal"	"Carrer de Ramón y Cajal"						
"Plaça de Felip Alcántara"	"Plaça de Felip Alcántara"						
"Carrer de Llorenç Pahissa"	"Carrer de Llorenç Pahissa"						
"Carrer Pou de Sant Pere"	"Carrer Pou de Sant Pere"						
"Plaça d'Alfons Comín"	"Plaça d'Alfons Comín"						
"Plaça Elisabeth Eidenbenz"	"Plaça Elisabeth Eidenbenz"						
"Carrer del Sol"	"Carrer del Sol"						
"Carrer de Santiago Rusiñol"	"Carrer de Santiago Rusiñol"						
"Carrer dels Germans Lladó"	"Carrer dels Germans Lladó"						
"Carrer de Josep Ricart"	"Carrer de Josep Ricart"						
"Carrer de Joan de Batlle"	"Carrer de Joan de Batlle"						
"Carrer de Mossèn Cinto Verdaguer"	"Carrer de Mossèn Cinto Verdaguer"						
"Carrer dels Germans Carreras"	"Carrer dels Germans Carreras"						
"Carrer de la Verge de Montserrat"	"Carrer de la Verge de Montserrat"						
"Carrer de la Verge del Pilar"	"Carrer de la Verge del Pilar"						
"Carrer de Maria Noguera"	"Carrer de Maria Noguera"						
"Carrer de Ramon Ribas"	"Carrer de Ramon Ribas"						
"Carrer del General Manso"	"Carrer del General Manso"						
"Plaça de l'Estació"	"Plaça de l'Estació"						
"Carrer Girona"	"Carrer Girona"						
"Plaça de la Solidaritat"	"Plaça de la Solidaritat"						
"Carrer Rectoria"	"Carrer Rectoria"						
"Plaça de la Vila"	"Plaça de la Vila"						
"Carrer Torras i Bages"	"Carrer Torras i Bages"						
"Carrer Montserrat"	"Carrer Montserrat"						
"Carrer de Joan Maragall"	"Carrer de Joan Maragall"						
"Carrer Sant Llorenç"	"Carrer Sant Llorenç"						
"Carrer Vidal i Ribas"	"Carrer Vidal i Ribas"						
"Carrer de Josep Irla"	"Carrer de Josep Irla"						
"Carrer de Josep Tarradellas"	"Carrer de Josep Tarradellas"						
"Carrer de Josep Gaspà"	"Carrer de Josep Gaspà"						
"Carrer de Joana Raspall"	"Carrer de Joana Raspall"						
"Plaça de Lluís Companys"	"Plaça de Lluís Companys"						
"Plaça del Casal de Joves"	"Plaça del Casal de Joves"						
"Plaça del Doctor Behring"	"Plaça del Doctor Behring"						
"Carrer del Terrisser"	"Carrer del Terrisser"						
"Carrer de Sant Jaume"	"Carrer de Sant Jaume"						
"Carrer dels Països Catalans"	"Carrer dels Països Catalans"						
"Carrer de Jaume Balmes"	"Carrer de Jaume Balmes"						
"Carrer de Sant Gabriel"	"Carrer de Sant Gabriel"						
"Carrer de Joaquim Prats"	"Carrer de Joaquim Prats"						
"Carrer Riera de Pahissa"	"Carrer Riera de Pahissa"						
"Carrer Treball"	"Carrer Treball"						
"Carrer Indústria"	"Carrer Indústria"						
"Carrer de Ramón de Trincheria"	"Carrer de Ramón de Trincheria"						
"Plaça de Catalunya"	"Plaça de Catalunya"						
"Carrer de Ventura i Gassol"	"Carrer de Ventura i Gassol"						
"Carrer de Prolongació de Falguera"	"Carrer de Prolongació de Falguera"						
"Carrer Verge de la Salut"	"Carrer Verge de la Salut"						
"Carrer de Josep Teixidor"	"Carrer de Josep Teixidor"						
"Carrer de l'Hospitalet"	"Carrer de l'Hospitalet"						
"Carrer de Miquel Coll i Alentorn"	"Carrer de Miquel Coll i Alentorn"						
"Carrer de Jaume Vidal"	"Carrer de Jaume Vidal"						
"Carrer de Pere IV"	"Carrer de Pere IV"						
"Carrer de Tirant lo Blanc"	"Carrer de Tirant lo Blanc"						
"Carrer de Pere Àlvarez"	"Carrer de Pere Àlvarez"						
"Carrer de Joan Salvat Papasseït"	"Carrer de Joan Salvat Papasseït"						
"Parc de Bombers de Sant Feliu de Llobregat"	"Parc de Bombers de Sant Feliu de Llobregat"						
"Carrer de Picasso"	"Carrer de Picasso"						
"Plaça de la Falguera"	"Plaça de la Falguera"						
"Carrer de la Constitució"	"Carrer de la Constitució"						
"Plaça Vinya del Puntaire"	"Plaça Vinya del Puntaire"						
"Carrer del Reverend Martí Duran"	"Carrer del Reverend Martí Duran"						
"Carrer de Lluís G.Rius"	"Carrer de Lluís G.Rius"						
"Plaça de la Salut"	"Plaça de la Salut"						
"Carrer del General Prim"	"Carrer del General Prim"						
"Parc de Can Llobera"	"Parc de Can Llobera"						
"Carrer del Comerç"	"Carrer del Comerç"						
"Carrer de Mataró"	"Carrer de Mataró"						
"Parc del Cerdanet"	"Parc del Cerdanet"						
"Plaça de Can Llobera"	"Plaça de Can Llobera"						
"Parc de la Pineda de la Salut"	"Parc de la Pineda de la Salut"						
"Carrer de l'Agricultura"	"Carrer de l'Agricultura"						
"Carrer de Granollers"	"Carrer de Granollers"						
"Carrer de Joaquim Montmany"	"Carrer de Joaquim Montmany"						
"Plaça de Pere Dot"	"Plaça de Pere Dot"						
"Carrer de Joan XXIII"	"Carrer de Joan XXIII"						
"Carrer Riera de la Salut"	"Carrer Riera de la Salut"						
"Carrer de la Santa Creu"	"Carrer de la Santa Creu"						
"Carrer de Llorenç Martí"	"Carrer de Llorenç Martí"						
"Carrer de les Roses"	"Carrer de les Roses"						
"Carrer dels Tallers"	"Carrer dels Tallers"						
"Carrer de Pizarro"	"Carrer de Pizarro"						
"Carrer Francesc Sáez"	"Carrer Francesc Sáez"						
"Carrer del Doctor Fleming"	"Carrer del Doctor Fleming"						
"Parc Nadal"	"Parc Nadal"						
"Carrer Sagrament"	"Carrer Sagrament"						
"Plaça de les Roses"	"Plaça de les Roses"						
"Carrer de les Filadores"	"Carrer de les Filadores"						
"Parc de la Masia Can Dot"	"Parc de la Masia Can Dot"						
"Plaça de Montserrat Roig"	"Plaça de Montserrat Roig"						
"Carrer Doctor Fleming"	"Carrer Doctor Fleming"						
"Plaça Laujar d'Andarax"	"Plaça Laujar d'Andarax"						
"Plaça de la Xocolatada"	"Plaça de la Xocolatada"						
"Plaça Plutó"	"Plaça Plutó"						
"Plaça Neptú"	"Plaça Neptú"						
"Plaça Ferrer i Guàrdia"	"Plaça Ferrer i Guàrdia"						
"Plaça de les Vinyes"	"Plaça de les Vinyes"						
"Plaça de Francesc Macià"	"Plaça de Francesc Macià"						
"Carrer de Margarida Xirgu"	"Carrer de Margarida Xirgu"						
"Carrer Mas Lluhí"	"Carrer Mas Lluhí"						
"Carrer del Marquès de Monistrol"	"Carrer del Marquès de Monistrol"						
"Carrer de Joan Batlle"	"Carrer de Joan Batlle"						
"Carrer del Doctor Brogueroles"	"Carrer del Doctor Brogueroles"						
"Carrer del Tibidabo"	"Carrer del Tibidabo"						
"Carrer Estelí"	"Carrer Estelí"						
"Carrer de Matilde Bertran"	"Carrer de Matilde Bertran"						
"Carrer de Jacint Rius"	"Carrer de Jacint Rius"						
"Plaça Dicià"	"Plaça Dicià"						
"Carrer de Girona"	"Carrer de Girona"						
"Carrer del Baix Llobregat"	"Carrer del Baix Llobregat"						
"Carrer de Joan García Nieto"	"Carrer de Joan García Nieto"						
"Carrer Joan Fuster i Ortells"	"Carrer Joan Fuster i Ortells"						
"Parc de les Grases"	"Parc de les Grases"						
"Plaça de la Llibertat"	"Plaça de la Llibertat"						
"Carrer de Frederica Montseny"	"Carrer de Frederica Montseny"						
"Camí de la Font de Sansa"	"Camí de la Font de Sansa"						
"Camí dels Esterragalls"	"Camí dels Esterragalls"						
"Parc infantil plaça del poble"	"Parc infantil plaça del poble"						
"Camí dels Espuis. Acces Rec del Solà"	"Camí dels Espuis. Acces Rec del Solà"						
"Plaça Guillemó"	"Plaça Guillemó"						
"Camí dels Espuis"	"Camí dels Espuis"						
"Carrer dels Castanyers"	"Carrer dels Castanyers"						
"Carrer Tossalet i Vinyols"	"Carrer Tossalet i Vinyols"						
"Carrer de i'Aern"	"Carrer de i'Aern"						
"Carrer Prat Salit"	"Carrer Prat Salit"						
"Avinguda de Salou"	"Avinguda de Salou"						
"Carrer Mossèn Lluis Pujol"	"Carrer Mossèn Lluis Pujol"						
"Carrer del Barrers"	"Carrer del Barrers"						
"Avinguda de Santa Coloma"	"Avinguda de Santa Coloma"						
"Camí del Riu Valira"	"Camí del Riu Valira"						
"Carrer de la Tartera"	"Carrer de la Tartera"						
"Avinguda d'Enclar"	"Avinguda d'Enclar"						
"Carrer Major"	"Carrer Major"						
"Parc de Bombers d'Andorra la Vella"	"Parc de Bombers d'Andorra la Vella"						
"Parc de la Serradora"	"Parc de la Serradora"						
"Parc del Roure"	"Parc del Roure"						
"Carrer Roureda Tapada"	"Carrer Roureda Tapada"						
"Carrer Camp Pauet"	"Carrer Camp Pauet"						
"Carrer de Cedre"	"Carrer de Cedre"						
"Parc del Contrapàs"	"Parc del Contrapàs"						
"Parc del Cedre"	"Parc del Cedre"						
"Carrer Camp Bastida"	"Carrer Camp Bastida"						
"Carrer de les Costes"	"Carrer de les Costes"						
"Camí Vell"	"Camí Vell"						
"Carrer de la Closa"	"Carrer de la Closa"						
"Carrer Antic Camí Ral"	"Carrer Antic Camí Ral"						
"Carrer Prat de la Creu"	"Carrer Prat de la Creu"						
"Carrer de la Grau"	"Carrer de la Grau"						
"Carrer Mestre Xavier Plana"	"Carrer Mestre Xavier Plana"						
"Carrer Bonavista"	"Carrer Bonavista"						
"Carrer Roureda de Sansa"	"Carrer Roureda de Sansa"						
"Carrer Prada Motxilla"	"Carrer Prada Motxilla"						
"Carrer Solà del Jan"	"Carrer Solà del Jan"						
"Carrer Terra Vella"	"Carrer Terra Vella"						
"Avinguda de Tarragona"	"Avinguda de Tarragona"						
"Avinguda del Princep Benlloch"	"Avinguda del Princep Benlloch"						
"Carrer de l'Alzinaret"	"Carrer de l'Alzinaret"						
"Carrer Gil Torres"	"Carrer Gil Torres"						
"Plaça del monument a l'immigrant"	"Plaça del monument a l'immigrant"						
"Carrer Anna Maria Janer"	"Carrer Anna Maria Janer"						
"Avinguda Santa Coloma"	"Avinguda Santa Coloma"						
"Carrer del Currubell"	"Carrer del Currubell"						
"Carrer Roc de l'Aldias"	"Carrer Roc de l'Aldias"						
"Carrer Ciutat de Valls"	"Carrer Ciutat de Valls"						
"Carrer de la Tobira"	"Carrer de la Tobira"						
"Carrer de la Vall"	"Carrer de la Vall"						
"Carrer del Pui"	"Carrer del Pui"						
"Carrer del Puial"	"Carrer del Puial"						
"Avinguda Prat de la Creu"	"Avinguda Prat de la Creu"						
"Carrer Pratd el Rull"	"Carrer Pratd el Rull"						
"Carrer del Tossal"	"Carrer del Tossal"						
"Carrer Castellà del Sucarà"	"Carrer Castellà del Sucarà"						
"Carrer Font de Ferrús"	"Carrer Font de Ferrús"						
"Carrer de la Font del Puial"	"Carrer de la Font del Puial"						
"Carrer Font del Puial"	"Carrer Font del Puial"						
"Camí Ral de la Massana a Andorra"	"Camí Ral de la Massana a Andorra"						
"Carrer Esteve Dolsa Pujal"	"Carrer Esteve Dolsa Pujal"						
"Carrer Dr. Molines"	"Carrer Dr. Molines"						
"Parc Central"	"Parc Central"			"Parc Central d'Andorra, Parc Central, Parc Central d'Andorra la Vella"	"Parc Central d'Andorra"	"park"	"Q7136369"
"Carrer Maria Plà"	"Carrer Maria Plà"						
"Avinguda del Fener"	"Avinguda del Fener"						
"Carrer de la Creu Grossa"	"Carrer de la Creu Grossa"						
"Avinguda Consell d'Europa"	"Avinguda Consell d'Europa"						
"Avinguda Doctor Mitjavila"	"Avinguda Doctor Mitjavila"						
"Carrer Bisbe Príncep Iglésias"	"Carrer Bisbe Príncep Iglésias"						
"Avinguda Meritxell"	"Avinguda Meritxell"						
"Carrer de la Roda"	"Carrer de la Roda"						
"Carrer dels Canals"	"Carrer dels Canals"						
"Carrer Fiter i Rossell"	"Carrer Fiter i Rossell"						
"Carrer Closes de Guillemó"	"Carrer Closes de Guillemó"						
"Camí Prada Casadet"	"Camí Prada Casadet"						
"Avinguda de la Borda Nova"	"Avinguda de la Borda Nova"						
"Carrer de la Sobrevia"	"Carrer de la Sobrevia"						
"Carrer Prada Casadet"	"Carrer Prada Casadet"						
"Carrer Mossèn Enric Marfany"	"Carrer Mossèn Enric Marfany"						
"Carrer Doctor Nequí"	"Carrer Doctor Nequí"						
"Carrer Mossèn Tremosa"	"Carrer Mossèn Tremosa"						
"Carrer Doctor Vilanova"	"Carrer Doctor Vilanova"						
"Carrer Dr. Vilanova"	"Carrer Dr. Vilanova"						
"Carrer La Llacuna"	"Carrer La Llacuna"						
"Carrer de la Llacuna"	"Carrer de la Llacuna"						
"Parc Central 2"	"Parc Central 2"						
"Plaça del Poble"	"Plaça del Poble"			"Plaça del Poble, plaça del Poble"	"Plaça del Poble"	"square"	"Q18005708"
"Plaça Rebés"	"Plaça Rebés"						
"Carrer de la Vinyeta"	"Carrer de la Vinyeta"						
"Carrer Esteve Dolsa Pujol"	"Carrer Esteve Dolsa Pujol"						
"Plaça Lidia Armengol"	"Plaça Lidia Armengol"						
"Carrer Roc dels Escolls"	"Carrer Roc dels Escolls"						
"Carrer Consòrcia"	"Carrer Consòrcia"						
"Carrer del Consell General"	"Carrer del Consell General"						
"Carrer Mossèn Cinto Verdaguer"	"Carrer Mossèn Cinto Verdaguer"						
"Camí del Roc de les Bruixes"	"Camí del Roc de les Bruixes"						
"Carrer Bonaventura Riberaygua"	"Carrer Bonaventura Riberaygua"						
"Carrer de Joan Maragall"	"Carrer de Joan Maragall"						
"Carrer Pere d'Urg"	"Carrer Pere d'Urg"						
"Carrer de l'Aigüeta"	"Carrer de l'Aigüeta"						
"Carrer de la Sardana"	"Carrer de la Sardana"						
"Carrer Verge del Pilar"	"Carrer Verge del Pilar"						
"Carrer Josep Rossell i Calva"	"Carrer Josep Rossell i Calva"						
"Carrer Ciutat de Consuegra"	"Carrer Ciutat de Consuegra"						
"Carrer Callaueta"	"Carrer Callaueta"						
"Carrer Bonaventura Armengol"	"Carrer Bonaventura Armengol"						
"carrer Prat de la Creu"	"carrer Prat de la Creu"						
"Carrer Roger Bernat III"	"Carrer Roger Bernat III"						
"Carrer Pau Casals"	"Carrer Pau Casals"						
"Plaça de la Sardana"	"Plaça de la Sardana"						
"Carrer Sant Salvador"	"Carrer Sant Salvador"						
"Carrer d'Emprivat"	"Carrer d'Emprivat"						
"Plaça la Rotonda"	"Plaça la Rotonda"						
"Carrer Joan Cornella Panicello"	"Carrer Joan Cornella Panicello"						
"Carrer Babot Camp"	"Carrer Babot Camp"						
"Camí del Parc Central"	"Camí del Parc Central"						
"Carrer de la Borda"	"Carrer de la Borda"						
"Plaça The Cloud"	"Plaça The Cloud"						
"Plaça Mestre Joan Roure"	"Plaça Mestre Joan Roure"						
"Carrer de Sant Esteve"	"Carrer de Sant Esteve"						
"Carrer Sant Andreu"	"Carrer Sant Andreu"						
"Carrer Roc dels Pouets"	"Carrer Roc dels Pouets"						
"Carrer de la Grella"	"Carrer de la Grella"						
"Camí del Pont Pla"	"Camí del Pont Pla"						
"Carrer Parc Guillemó"	"Carrer Parc Guillemó"						
"Avinguda Fiter i Rossell"	"Avinguda Fiter i Rossell"						
"Camí del Falgueró"	"Camí del Falgueró"						
"Camí del Rec d'Andorra"	"Camí del Rec d'Andorra"						
"Avinguda Meritxell"	"Avinguda Meritxell"			"Avinguda de Meritxell"	"Avinguda de Meritxell"	"allée"	"Q17042536"
"Plaça Príncep Benlloch"	"Plaça Príncep Benlloch"						
"Camí de l'Estany de la Nou"	"Camí de l'Estany de la Nou"						
"Avinguda Carlemany"	"Avinguda Carlemany"						
"Carrer de Parnal"	"Carrer de Parnal"						
"Carrer de la Constituciò"	"Carrer de la Constituciò"						
"Avinguda del Pont de la Tosca"	"Avinguda del Pont de la Tosca"						
"Carrer d'Engordany"	"Carrer d'Engordany"						
"Avinguda Coprincep de Gaulle"	"Avinguda Coprincep de Gaulle"						
"Carrer François Mitterrand"	"Carrer François Mitterrand"						
"Avinguda de les Escoles"	"Avinguda de les Escoles"						
"Camí de la Font del Gat"	"Camí de la Font del Gat"						
"Camí d'Ensucaranes"	"Camí d'Ensucaranes"						
"Camí de les Molleres"	"Camí de les Molleres"						
"Camí del Coll de Caldes"	"Camí del Coll de Caldes"						
"Carrer Ciutat de Sabadell"	"Carrer Ciutat de Sabadell"						
"Carrer Isabelle Sandy"	"Carrer Isabelle Sandy"						
"Carrer Prat Gran"	"Carrer Prat Gran"						
"Avinguda Consell de la Terra"	"Avinguda Consell de la Terra"						
"Carrer Paraires"	"Carrer Paraires"						
"Carrer Pare Enric Graner"	"Carrer Pare Enric Graner"						
"Carrer Nou"	"Carrer Nou"						
"Plaça Coprínceps"	"Plaça Coprínceps"						
"Carrer de les Boïgues"	"Carrer de les Boïgues"						
"Carrer Sant Antoni"	"Carrer Sant Antoni"						
"Carrer del Prat Gran"	"Carrer del Prat Gran"						
"Carrer Santa Anna"	"Carrer Santa Anna"						
"Carrer del Picó"	"Carrer del Picó"						
"Carrer Mossén Guillem Adellach"	"Carrer Mossén Guillem Adellach"						
"Carrer de l'obac"	"Carrer de l'obac"						
"Carrer d'Engordany"	"Carrer d'Engordany"			"Pont d'Engordany, pont d'Engordany, Pont d'Escaldes-Engordany"	"Pont d'Engordany"	"road bridge"	"Q7228015"
"Camí de la Canaleta"	"Camí de la Canaleta"						
"Camí de la Plana"	"Camí de la Plana"						
"Camí d'Engolasters"	"Camí d'Engolasters"						
"Carrer de l'Hort"	"Carrer de l'Hort"						
"Plaça de les Pubilles"	"Plaça de les Pubilles"						
"Plaça de l'Església"	"Plaça de l'Església"						
"Plaça dels Safarejos"	"Plaça dels Safarejos"						
"Camí del Barri"	"Camí del Barri"						
"Camí de la Muntanya"	"Camí de la Muntanya"						
"Carrer Prat de Rogetó"	"Carrer Prat de Rogetó"						
"Carrer de les Teulades"	"Carrer de les Teulades"						
"Camí dels Vilars"	"Camí dels Vilars"						
"Carrer de l'Étang Salé"	"Carrer de l'Étang Salé"						
"Carrer dels Pardals"	"Carrer dels Pardals"						
"Carrer Josep Viladomat"	"Carrer Josep Viladomat"						
"Carrer dels Escalls"	"Carrer dels Escalls"						
"Carrer Esteve Albert"	"Carrer Esteve Albert"						
"Avinguda del Pessebre"	"Avinguda del Pessebre"						
"Carrer dels Veedors"	"Carrer dels Veedors"						
"Plaça dels dos Vaires"	"Plaça dels dos Vaires"						
"Parc de la Mola"	"Parc de la Mola"						
"Camí del Valira"	"Camí del Valira"						
"Carrer de Coll de Jou"	"Carrer de Coll de Jou"						
"Carrer de Can Diunange"	"Carrer de Can Diunange"						
"Plaça de Lalín"	"Plaça de Lalín"						
"Camí de Cal Diumenge"	"Camí de Cal Diumenge"						
"Camí de la Vinya"	"Camí de la Vinya"						
"Carrer de la Parròquia"	"Carrer de la Parròquia"						
"Carrer Batlle Tomàs"	"Carrer Batlle Tomàs"						
"Camí de la Gavernera"	"Camí de la Gavernera"						
"Camí de la Grau"	"Camí de la Grau"						
"Camí de la Font"	"Camí de la Font"						
"Avinguda Sant Jaume"	"Avinguda Sant Jaume"						
"Camí de la Peletera"	"Camí de la Peletera"						
"Camí del Roc"	"Camí del Roc"						
"Camí de la Canya"	"Camí de la Canya"						
"Carrer de Can Diumenge"	"Carrer de Can Diumenge"						
"Carrer de Roca Corba"	"Carrer de Roca Corba"						
"Carrer de l'Anglata"	"Carrer de l'Anglata"						
"Camí de La Salita"	"Camí de La Salita"						
"Carrer de la Devesa"	"Carrer de la Devesa"						
"Camí del Mig"	"Camí del Mig"						
"Camí de les Agulles d'Engolasters"	"Camí de les Agulles d'Engolasters"						
"Camí de l'Ossa"	"Camí de l'Ossa"						
"Avinguda Carlemany"	"Avinguda Carlemany"			"Avinguda de Carlemany, avinguda de Carlemany, Avinguda Carlemany"	"Avinguda de Carlemany"	"allée"	"Q11907388"
"Plaça de Santa Anna"	"Plaça de Santa Anna"						
"Plaça dels Dos Valires"	"Plaça dels Dos Valires"						
"Camí de Percanela (cartell a la paret)"	"Camí de Percanela (cartell a la paret)"						
"Parc Natural Comunal de les Valls de Comapedrosa"	"Parc Natural Comunal de les Valls de Comapedrosa"						
"Camí de Percanela"	"Camí de Percanela"						
"Parc Natural de les Valls del Comapedrosa"	"Parc Natural de les Valls del Comapedrosa"						
"Camí de Turer"	"Camí de Turer"						
"Camí Ral de la Massana a Andorra"	"Camí Ral de la Massana a Andorra"						
"Avinguda del Jovell"	"Avinguda del Jovell"						
"Avinguda de Sant Antoni"	"Avinguda de Sant Antoni"						
"Carrer Colomer"	"Carrer Colomer"						
"Carrer de Sant Joan Vell"	"Carrer de Sant Joan Vell"						
"Camí Ral de la Massana"	"Camí Ral de la Massana"						
"Camí de Padern"	"Camí de Padern"						
"Camí de les Majobames"	"Camí de les Majobames"						
"Camí de les Callisses"	"Camí de les Callisses"						
"Camí del Querol"	"Camí del Querol"						
"Carrer de l'Alfals"	"Carrer de l'Alfals"						
"Carrer Josep Areny"	"Carrer Josep Areny"						
"Carrer Guillem Areny"	"Carrer Guillem Areny"						
"Carrer de Santa Caterina"	"Carrer de Santa Caterina"						
"Carrer dels Plans"	"Carrer dels Plans"						
"Carrer del Pui"	"Carrer del Pui"						
"Carrer de les Escoles"	"Carrer de les Escoles"						
"Carrer dels Ocells"	"Carrer dels Ocells"						
"Parc Prat Gran"	"Parc Prat Gran"						
"Carrer Coma Del Colat"	"Carrer Coma Del Colat"						
"Avinguda Sant Antoni"	"Avinguda Sant Antoni"						
"Avinguda del Ravell"	"Avinguda del Ravell"						
"Avinguda del Través"	"Avinguda del Través"						
"Camí Ral de la Massana (Nou Traçat)"	"Camí Ral de la Massana (Nou Traçat)"						
"Camí Ral de la Massana (Antic Traçat)"	"Camí Ral de la Massana (Antic Traçat)"						
"Carrer dels Hortals"	"Carrer dels Hortals"						
"Camí Cap del Carrer"	"Camí Cap del Carrer"						
"Carrer Dr Vilanova"	"Carrer Dr Vilanova"						
"Avinguda el Travès"	"Avinguda el Travès"						
"Carrer de les Palanques"	"Carrer de les Palanques"						
"Carrer de Cal Teixidó"	"Carrer de Cal Teixidó"						
"Carrer el Travès"	"Carrer el Travès"						
"Carrer de les Entrades"	"Carrer de les Entrades"						
"Carrer de Josep Rossel"	"Carrer de Josep Rossel"						
"Plaça de les Fontetes"	"Plaça de les Fontetes"						
"Camí de l'Església"	"Camí de l'Església"						
"Carrer de les Fontetes"	"Carrer de les Fontetes"						
"Parc de l'Anita"	"Parc de l'Anita"						
"Carrer Sant Romà"	"Carrer Sant Romà"						
"Camí de les Barreres"	"Camí de les Barreres"						
"Avinguda del Pont d'Ordino"	"Avinguda del Pont d'Ordino"						
"Carrer de les Boigues"	"Carrer de les Boigues"						
"Camí de la Gonarda"	"Camí de la Gonarda"						
"Carrer de la Font del Colom"	"Carrer de la Font del Colom"						
"Carrer de Cal Jep"	"Carrer de Cal Jep"						
"Carrer de les Terres Majors de Dalt"	"Carrer de les Terres Majors de Dalt"						
"Carrer de les Terres Majors Baix"	"Carrer de les Terres Majors Baix"						
"Carrer del Serrat del Camp"	"Carrer del Serrat del Camp"						
"Carrer Urbanització Pleta de l'Aldosa"	"Carrer Urbanització Pleta de l'Aldosa"						
"Avinguda del Lloser"	"Avinguda del Lloser"						
"Carrer Cal Giberga"	"Carrer Cal Giberga"						
"Camí de les Costes de Giberga"	"Camí de les Costes de Giberga"						
"Carrer de l'Hortal"	"Carrer de l'Hortal"						
"Carrer de Casa Aldosa"	"Carrer de Casa Aldosa"						
"Plaça de l'Església"	"Plaça de l'Església"						
"Plaça Francesc Areny Parramón"	"Plaça Francesc Areny Parramón"						
"Parc Natural Comunal de les Valls del Comapedrosa"	"Parc Natural Comunal de les Valls del Comapedrosa"						
"Camí Ral-Arans"	"Camí Ral-Arans"						
"camí de la marta"	"camí de la marta"						
"Carrer de Santa Caterina"	"Carrer de Santa Caterina"						
"Avinguda del Través"	"Avinguda del Través"						
"Carrer del Solà"	"Carrer del Solà"						
"Carrer de les Massanelles"	"Carrer de les Massanelles"						
"Avinguda del Pont d'Ordino"	"Avinguda del Pont d'Ordino"						
"Camí de la Gonarda"	"Camí de la Gonarda"						
"Avinguda del Lloser"	"Avinguda del Lloser"						
"camí del Campi"	"camí del Campi"						
"Carrer de l'Anglada"	"Carrer de l'Anglada"						
"Carrer del Condalet"	"Carrer del Condalet"						
"Carrer Narciso Yepes"	"Carrer Narciso Yepes"						
"Carrer del Clos"	"Carrer del Clos"						
"Camí Ral"	"Camí Ral"						
"Avinguda del Casamanya"	"Avinguda del Casamanya"						
"Carrer dels Coms"	"Carrer dels Coms"						
"Plaça Major"	"Plaça Major"						
"Plaça de Ferino"	"Plaça de Ferino"						
"Carrer Perdut"	"Carrer Perdut"						
"Carrer del Turer"	"Carrer del Turer"						
"Carrer del Mig"	"Carrer del Mig"						
"Carrer del Pradàs"	"Carrer del Pradàs"						
"Carrer del Camp de la Tanada"	"Carrer del Camp de la Tanada"						
"Carrer de la Covanella"	"Carrer de la Covanella"						
"Plaça d'Arcalís"	"Plaça d'Arcalís"						
"Plaça de Terra Major"	"Plaça de Terra Major"						
"Plaça de Plandolit"	"Plaça de Plandolit"						
"Plaça de Sant Corneli"	"Plaça de Sant Corneli"						
"Carrer de Casamanya"	"Carrer de Casamanya"						
"Carrer dels Mollassos"	"Carrer dels Mollassos"						
"Carrer Aubell"	"Carrer Aubell"						
"Camí de la Tanada"	"Camí de la Tanada"						
"Carrer de Tristaina"	"Carrer de Tristaina"						
"Carrer del Puiet"	"Carrer del Puiet"						
"Carrer del Peu del Puiet"	"Carrer del Peu del Puiet"						
"Carrer Manual Digest"	"Carrer Manual Digest"						
"Carrer de Mossèn Cinto Verdaguer"	"Carrer de Mossèn Cinto Verdaguer"						
"Plaça de la Covanella"	"Plaça de la Covanella"						
"Carrer Antoni Fiter i Rossell"	"Carrer Antoni Fiter i Rossell"						
"Carrer de les Canals"	"Carrer de les Canals"						
"Carrer del Regat"	"Carrer del Regat"						
"Camí del Portal del Riu"	"Camí del Portal del Riu"						
"Carrer de Pau"	"Carrer de Pau"						
"Carrer de l'Obac"	"Carrer de l'Obac"						
"Carrer de la Costa del Pui"	"Carrer de la Costa del Pui"						
"Camí dels Fargaires"	"Camí dels Fargaires"						
"Carrer de Sornás"	"Carrer de Sornás"						
"Camí Ral d'Ordino"	"Camí Ral d'Ordino"						
"camí al Roc del Castell"	"camí al Roc del Castell"						
"Parc Natural de la Vall de Sorteny"	"Parc Natural de la Vall de Sorteny"			"Parc natural de la vall de Sorteny, Parc Natural de Sorteny"	"Parc natural de la vall de Sorteny"	"protected area"	"Q3364586"
"Camí de les Pardines (peatonal)"	"Camí de les Pardines (peatonal)"						
"Avinguda Coprincep Épiscopal"	"Avinguda Coprincep Épiscopal"						
"Avinguda de Joan Martí"	"Avinguda de Joan Martí"						
"Carrer del Doro"	"Carrer del Doro"						
"Carrer Hort de Godi"	"Carrer Hort de Godi"						
"Carrer del Predal"	"Carrer del Predal"						
"Carrer Perdut"	"Carrer Perdut"						
"Avinguda de François Mitterrand"	"Avinguda de François Mitterrand"						
"Carrer dels Avellaners"	"Carrer dels Avellaners"						
"Avinguda Princep Benlloch"	"Avinguda Princep Benlloch"						
"Carrer de la Girauda"	"Carrer de la Girauda"						
"Carrer dels Arínsols"	"Carrer dels Arínsols"						
"Carrer de la Vena"	"Carrer de la Vena"						
"Carrer Sant Miquel"	"Carrer Sant Miquel"						
"Carrer Major"	"Carrer Major"						
"Carrer dels Cavallers"	"Carrer dels Cavallers"						
"Carrer de la Mosquera"	"Carrer de la Mosquera"						
"Carrer del Triader"	"Carrer del Triader"						
"Carrer Mirador d'Encamp"	"Carrer Mirador d'Encamp"						
"Carrer d'Englolaster"	"Carrer d'Englolaster"						
"Parc de la Gent Gran"	"Parc de la Gent Gran"						
"Carrer del Molí"	"Carrer del Molí"						
"Camí del Tirader"	"Camí del Tirader"						
"Plaça del Consell"	"Plaça del Consell"						
"Plaça Sant Miquel"	"Plaça Sant Miquel"						
"Carrer de la Plana"	"Carrer de la Plana"						
"Camí del Canal"	"Camí del Canal"						
"Carrer dels Ajustants"	"Carrer dels Ajustants"						
"Camí del Grau de la Molina"	"Camí del Grau de la Molina"						
"Camí de l'Ossa"	"Camí de l'Ossa"						
"Carrer del Catorze de Març"	"Carrer del Catorze de Març"						
"Carrer René Baulard"	"Carrer René Baulard"						
"Carrer de la Ciutat Pubilla"	"Carrer de la Ciutat Pubilla"						
"Camí de Lloset"	"Camí de Lloset"						
"Camí de Pessons"	"Camí de Pessons"						
"Carrer Solana"	"Carrer Solana"						
"Carrer de Catalunya"	"Carrer de Catalunya"						
"Avinguda d'Encamp"	"Avinguda d'Encamp"						
"Carrer Bearn"	"Carrer Bearn"						
"Carrer del Maià"	"Carrer del Maià"						
"Carrer de Sant Jordi"	"Carrer de Sant Jordi"						
"Carrer de les Abelletes"	"Carrer de les Abelletes"						
"Carrer Para Urgell"	"Carrer Para Urgell"						
"Plaça dels Coprínceps"	"Plaça dels Coprínceps"						
"Avinguda del Consell General"	"Avinguda del Consell General"						
"Carrer Comtes de Foix"	"Carrer Comtes de Foix"						
"Carrer Bernat III"	"Carrer Bernat III"						
"Carrer Pareatges"	"Carrer Pareatges"						
"carrer de les Garrigues"	"carrer de les Garrigues"						
"carrer de la Noguera"	"carrer de la Noguera"						
"carrer de la Carretera"	"carrer de la Carretera"						
"Carrer de Patrici Redondo"	"Carrer de Patrici Redondo"						
"Carrer del Pou de Gel"	"Carrer del Pou de Gel"						
"Plaça Major"	"Plaça Major"						
"carrer de Pau Casals i Defiló"	"carrer de Pau Casals i Defiló"						
"Carrer de la Creu"	"Carrer de la Creu"						
"Carrer de la Bassa"	"Carrer de la Bassa"						
"Carrer de la Carretera"	"Carrer de la Carretera"						
"carrer del Riu Segre"	"carrer del Riu Segre"						
"Carrer de la Pleta"	"Carrer de la Pleta"						
"Carrer de les Borges Blanques"	"Carrer de les Borges Blanques"						
"carrer de les Arenetes"	"carrer de les Arenetes"						
"Carrer de les Eres"	"Carrer de les Eres"						
"carrer del Riu Ebre"	"carrer del Riu Ebre"						
"carrer de les Piscines"	"carrer de les Piscines"						
"Carrer de Mestra Carme Massot"	"Carrer de Mestra Carme Massot"						
"Carrer de les Corts Catalanes"	"Carrer de les Corts Catalanes"						
"Carrer del Segria"	"Carrer del Segria"						
"Carrer Nou"	"Carrer Nou"						
"carrer de les Corts Catalanes"	"carrer de les Corts Catalanes"						
"carrer de la Creu"	"carrer de la Creu"						
"Carrer de l'Esquirol"	"Carrer de l'Esquirol"						
"Carrer del Bec"	"Carrer del Bec"						
"Carrer del Bosc"	"Carrer del Bosc"						
"Camí de la Senyoreta"	"Camí de la Senyoreta"						
"Carrer El Llinas"	"Carrer El Llinas"						
"Carrer de la Geneta"	"Carrer de la Geneta"						
"Camí d'Auvinyà"	"Camí d'Auvinyà"	"Camí d'Aubinya"	"Camì d'Aubinya"				
"Plaça Fancesc Cairat"	"Plaça Fancesc Cairat"						
"Carrer Francesc Carat"	"Carrer Francesc Carat"						
"Carrer Francesc Escudé"	"Carrer Francesc Escudé"						
"Carrer Isidre Valls"	"Carrer Isidre Valls"						
"Carrer Mossèn Enric Marfany"	"Carrer Mossèn Enric Marfany"						
"Carrer Camp de Perot"	"Carrer Camp de Perot"						
"Avinguda Verge de Canòlich"	"Avinguda Verge de Canòlich"						
"carrer de les Escoles"	"carrer de les Escoles"						
"carrer Casa Comuna"	"carrer Casa Comuna"						
"Carrer de Loira"	"Carrer de Loira"						
"Carrer Carvajal de Hué"	"Carrer Carvajal de Hué"						
"Carrer Bonaventura Riera"	"Carrer Bonaventura Riera"						
"Plaça de la Germandat"	"Plaça de la Germandat"						
"avinguda Rocafort"	"avinguda Rocafort"						
"Camí de Sant Cerni"	"Camí de Sant Cerni"						
"Camí del Conangle al Coll de Pimés"	"Camí del Conangle al Coll de Pimés"						
"Carrer del Busqueret"	"Carrer del Busqueret"	"camí de Son Xigala"	"camí de Son Xigala"				
"Camí de Son Xigala"	"Camí de Son Xigala"	"camí de Son Xigala"	"camí de Son Xigala"				
"Plaça de Sant Francesc Xavier"	"Plaça de Sant Francesc Xavier"	"sa Pista"	"sa Pista"				
"Camí Fondo"	"Camí Fondo"	"camí vell de Llucmajor"	"camí vell de Llucmajor"				
"Carrer de Pedro Sans Garau"	"Carrer de Pedro Sans Garau"	"camí del Molí dels Reis"	"camí del Molí dels Reis"				
"Camí 140 o de na Cerdana"	"Camí 140 o de na Cerdana"	"camí de na Cerdana"	"camí de na Cerdana"				
"Carrer Miquel Pellisa"	"Carrer Miquel Pellisa"						
"Carrer del Pare Bartomeu Salvà"	"Carrer del Pare Bartomeu Salvà"						
"Plaça dels Nins"	"Plaça dels Nins"	"plaça de les Copinyes"	"plaça de les Copinyes"				
"Carrer Neira"	"Carrer Neira"	"carrer Major"	"carrer Major"				
"Camí dels Cóms"	"Camí dels Cóms"						
"Camí a la cascada i carretera"	"Camí a la cascada i carretera"						
"Camí de l'Obac"	"Camí de l'Obac"						
"Camí del Gall"	"Camí del Gall"						
"Camí del Canal"	"Camí del Canal"						
"Camí del Toll Bullidor"	"Camí del Toll Bullidor"						
"Camí del Bosc de Fontanals"	"Camí del Bosc de Fontanals"						
"Carrer Prat del Riu"	"Carrer Prat del Riu"						
"Carrer Perdut"	"Carrer Perdut"						
"Camí del Port Dret"	"Camí del Port Dret"						
"Camí de l'Obac"	"Camí de l'Obac"	"Camí obac de El Tarter"	"Camí obac de El Tarter"				
"Camí de l'Obac d'Incles"	"Camí de l'Obac d'Incles"						
"Camí de la Font del Trabenc"	"Camí de la Font del Trabenc"						
"Camí del Riu de Juclar"	"Camí del Riu de Juclar"						
"Camí del Refugi del Siscaró"	"Camí del Refugi del Siscaró"						
"Camí de la Cascada del Juclar"	"Camí de la Cascada del Juclar"						
"Camí del Port d'Incles"	"Camí del Port d'Incles"						
"Carrer de Johann Sebastian Bach"	"Carrer de Johann Sebastian Bach"	"carrer de Joan Sebastià Bach"	"carrer de Joan Sebastià Bach"				
"Carrer de Provença"	"Carrer de Provença"	"rambla de Llefià"	"rambla de Llefià"				
"Carrer de Richard Strauss"	"Carrer de Richard Strauss"	"carrer de Ricard Strauss"	"carrer de Ricard Strauss"				
"Carrer de Lepant"	"Carrer de Lepant"	"carrer de Lepanto"	"carrer de Lepanto"				
"Carrer de Don Pelai"	"Carrer de Don Pelai"	"carrer de Don Pelayo"	"carrer de Don Pelayo"				
"Carrer de Pablo Picasso"	"Carrer de Pablo Picasso"	"carrer de Pau Picasso"	"carrer de Pau Picasso"				
"Carrer de Mossèn Anton Romeu"	"Carrer de Mossèn Anton Romeu"	"carrer d'en Mossèn Anton Romeu"	"carrer d'en Mossèn Anton Romeu"				
"Plaça del Doctor Francesc Niubó i Mary"	"Plaça del Doctor Francesc Niubó i Mary"	"plaça del Doctor Niubó"	"plaça del Doctor Niubó"				
"Avinguda de Bac de Roda"	"Avinguda de Bac de Roda"	"pont del Torrent de la Font"	"pont del Torrent de la Font"				
"Carrer del Mestre Bretón"	"Carrer del Mestre Bretón"	"carrer de Tomás Bretón"	"carrer de Tomás Bretón"				
"Camí de Son Vell"	"Camí de Son Vell"						
"carrer de s'Escola"	"carrer de s'Escola"						
"Carrer d'en Joan Lliteres"	"Carrer d'en Joan Lliteres"	"carrer de Ciutat"	"carrer de Ciutat"				
"carrer Nicolau Primitiu"	"carrer Nicolau Primitiu"						
"carrer Bernat Ramon"	"carrer Bernat Ramon"						
"carrer Cronista Granell"	"carrer Cronista Granell"						
"carrer Cronista Ribelles"	"carrer Cronista Ribelles"						
"carrer Naturalista Fuser"	"carrer Naturalista Fuser"						
"Carrer d'Alcoi"	"Carrer d'Alcoi"						
"Carrer deFondal de Sant Martí"	"Carrer de Fondal de Sant Martí"	"carrer Fondal de Sant Martí"	"carrer Fondal de Sant Martí"				
"Carrer de la Selva del Camp"	"Carrer de la Selva del Camp"	"carrer Fondal de Sant Martí"	"carrer Fondal de Sant Martí"				
"Carrer de la Vinya"	"Carrer de la Vinya"	"carretera"	"carretera"				
"Carrer de la Vall Moronta"	"Carrer de la Vall Moronta"	"carretera"	"carretera"				
"Avinguda de l'Eix Central"	"Avinguda de l'Eix Central"	"carretera"	"carretera"				
"Avinguda de Serragalliners"	"Avinguda de Serragalliners"	"carretera"	"carretera"				
"Carrer Serra Mariola"	"Carrer Serra Mariola"						
"Carrer la Pilota"	"Carrer la Pilota"						
"Carrer Doctor Borras"	"Carrer Doctor Borras"						
"Carrer al Trull"	"Carrer al Trull"						
"Carrer del Dos de Maig"	"Carrer del Dos de Maig"						
"Avinguda del Mestre Serrano"	"Avinguda del Mestre Serrano"						
"Carrer de Salvador Perelló"	"Carrer de Salvador Perelló"						
"camí d'Onda a Artana"	"camí d'Onda a Artana"	"Pista de les Penyes Altes o Aragoneses"	"Pista de les Penyes Altes o Aragonesses"				
"Camí de la Llidona"	"Camí de la Llidona"	"senda de la pedrissa"	"senda de la pedrissa"				
"Carrer de la Font del Ferro"	"Carrer de la Font del Ferro"	"carrer de Nostra Senyora de Lourdes"	"carrer de Nostra Senyora de Lourdes"				
"Carrer Mare de Déu de Lourdes"	"Carrer Mare de Déu de Lourdes"	"carrer de Nostra Senyora de Lourdes"	"carrer de Nostra Senyora de Lourdes"				
"Carrer de la Mare de Déu de Lourdes"	"Carrer de la Mare de Déu de Lourdes"	"carrer de Nostra Senyora de Lourdes"	"carrer de Nostra Senyora de Lourdes"				
"camí de la Font del Moreu"	"camí de la Font del Moreu"	"Antic camí de les Martines a Can Guitard de la Riera"	"Antic camí de les Martines a Can Guitard de la Riera"				
"carrer del Raó"	"carrer del Raó"						
"Plaça d'Espanya"	"Plaça d'Espanya"	"plaça de les Palmeres"	"plaça de les Palmeres"				
"Plaça Espanya"	"Plaça Espanya"	"plaça de les Palmeres"	"plaça de les Palmeres"				
"carrer Josep Almela Guillem"	"carrer Josep Almela Guillem"						
"carrer Duanes"	"carrer Duanes"						
"Camí dels Monjos (PR-C 31), GR 6 i GR 173"	"Camí dels Monjos (PR-C 31), GR 6 i GR 173"	"pr-c31"	"pr-c31"				
"Camí dels Monjos"	"Camí dels Monjos"	"pr-c31"	"pr-c31"				
"Camí dels Monjos (PR-C 31) i GR 6"	"Camí dels Monjos (PR-C 31) i GR 6"	"pr-c31"	"pr-c31"				
"Camí Real"	"Camí Real"			"Camí Real (barri de València), Camí Real"	"Camí Real (barri de València)"	"neighborhood"	"Q8261292"
"Avinguda del Professor López Piñero (Historiador de la Medicina)"	"Avinguda del Professor López Piñero (Historiador de la Medicina)"	"Antiga Autopista de El Saler"	"Antiga Autopista de El Saler"				
"Carrer de Sant Benet"	"Carrer de Sant Benet"						
"Plaça Centenari"	"Plaça Centenari"						
"Plaça Evarist Botella"	"Plaça Evarist Botella"						
"Carrer barranc del Tramusser"	"Carrer barranc del Tramusser"						
"Carrer Manuel Chaqués"	"Carrer Manuel Chaqués"						
"Carrer de Salvador Ros i Ros"	"Carrer de Salvador Ros i Ros"						
"Parc Aventure du Soler"	"Parc Aventure du Soler"						
"Carrer Nou d'Octubre"	"Carrer Nou d'Octubre"	"Carrer 9 d'Octubre"					
"Carrer Collsacabra"	"Carrer Collsacabra"						
"Carrer Mercè Rodoreda"	"Carrer Mercè Rodoreda"						
"Parc Durand"	"Parc Durand"						
"Carrer de Sant Benet"	"Carrer de Sant Benet"						
"Carrer de l'Arquitecte Puig i Cadafalch"	"Carrer de l'Arquitecte Puig i Cadafalch"						
"Carrer de la Puríssima"	"Carrer de la Puríssima"	"la Fillola de Dalt"	"la Fillola de Dalt"				
"carrer d'Enmig"	"carrer d'Enmig"	"Camí Reial"	"Camí Reial"				
"carrer de Sant Benet"	"carrer de Sant Benet"						
"Camí antic de Marata"	"Camí antic de Marata"						
"Plaça de l'1 d'octubre"	"Plaça de l'1 d'octubre"	"la placeta"	"la placeta"				
"Carrer de Sant Benet"	"Carrer de Sant Benet"						
"Carrer d'Amprius"	"Carrer d'Amprius"						
"carrer Josep Ensenyat"	"carrer Josep Ensenyat"						
"carrer de Vicent Mari"	"carrer de Vicent Mari"						
"Parc animalier de Casteil"	"Parc animalier de Casteil"						
"Carrer Disset"	"Carrer Disset"						
"Camí del Molí"	"Camí del Molí"	"lo Camí"	"lo Camí"				
"Carrer Ferrer"	"Carrer Ferrer"	"carrer Nou"	"carrer Nou"				
"plaça de Jaume I"	"plaça de Jaume I"	"Plaça París"	"Plaça París"				
"camí de l'Horta d'Alfeig"	"camí de l'Horta d'Alfeig"	"Camí vell d'Alfondeguilla a Eslida"	"Camí vell d'Alfondeguilla a Eslida"				
"Plaça dels Països Catalans"	"Plaça dels Països Catalans"	"plaça de la Foneria"	"plaça de la Foneria"				
"carrer d'Olot"	"carrer d'Olot"	"Carretera d'Olot a Riudaura"	"Carretera d'Olot a Riudaura"				
"Carrer de Mossèn Cinto Verdaguer"	"Carrer de Mossèn Cinto Verdaguer"	"carretera d'Igualada"	"carretera d'Igualada"				
"camí del Soler Botei"	"camí del Soler Botei"	"Camí a l'ermita de Sant Sebastià"	"Camí a l'ermita de Sant Sebastià"				
"Avinguda Quatre"	"Avinguda Quatre"	"avinguda 4"	"avinguda 4"				
"Parc de Clairfont"	"Parc de Clairfont"						
"Camí de ses Ermites Velles"	"Camí de ses Ermites Velles"	"camí del Bosc"	"camí del Bosc"				
"Parc animalier des Angles"	"Parc animalier des Angles"						
"camí de Llucena o de la Trahuanta"	"camí de Llucena o de la Trahuanta"	"Pista del Mas de la Serra"	"Pista del Mas de la Serra"				
"Carrer del Bon Sol"	"Carrer del Bon Sol"	"camí de Can Campins"	"camí de Can Campins"				
