"name"	"name:ca"	"alt_name:ca"	"alt_name"	"translations"	"ca.wikipedia_page"	"wikidata_type"	"wikidata_id"
"Carrer de Provença"	"Carrer de Provença"	"rambla de Llefià"	"rambla de Llefià"				
"Carrer de Pablo Picasso"	"Carrer de Pablo Picasso"	"carrer de Pau Picasso"	"carrer de Pau Picasso"				
"Carrer de Mossèn Anton Romeu"	"Carrer de Mossèn Anton Romeu"	"carrer d'en Mossèn Anton Romeu"	"carrer d'en Mossèn Anton Romeu"				
"Avinguda de Bac de Roda"	"Avinguda de Bac de Roda"	"pont del Torrent de la Font"	"pont del Torrent de la Font"				
"Carrer de la Selva del Camp"	"Carrer de la Selva del Camp"	"carrer Fondal de Sant Martí"	"carrer Fondal de Sant Martí"				
"Plaça de Sant Francesc Xavier"	"Plaça de Sant Francesc Xavier"	"sa Pista"	"sa Pista"				
"Camí Fondo"	"Camí Fondo"	"camí vell de Llucmajor"	"camí vell de Llucmajor"				
"Camí 140 o de na Cerdana"	"Camí 140 o de na Cerdana"	"camí de na Cerdana"	"camí de na Cerdana"				
"Plaça dels Nins"	"Plaça dels Nins"	"plaça de les Copinyes"	"plaça de les Copinyes"				
"Platja de La Romana"	"Platja de La Romana"	"platja dels Morts"	"platja dels Morts"	"platja de la Romana, platja dels Morts"		"white sand beach"	"Q107264672"
"Plaça de Ramon Llull"	"Plaça de Ramon Llull"	"plaça des Mercat"	"plaça des Mercat"				
"Carrer d'en Joan Lliteres"	"Carrer d'en Joan Lliteres"	"carrer de Ciutat"	"carrer de Ciutat"				
"Pla de Fernando"	"Pla de Fernando"						
"carrer Nicolau Primitiu"	"carrer Nicolau Primitiu"		"Calle de Nicolau Primitiu"				
"carrer Bernat Ramon"	"carrer Bernat Ramon"		"Calle del Cronista Granell"				
"carrer Cronista Ribelles"	"carrer Cronista Ribelles"		"Calle del Cronista Ribelles"				
"pla de l’Aljub"	"pla de l’Aljub"						
"Camí de ses Ermites Velles"	"Camí de ses Ermites Velles"	"camí del Bosc"	"camí del Bosc"				
"Rec de Tubau"	"Rec de Tubau"						
"Rec Del Masot"	"Rec Del Masot"						
"Carrer de la Vinya"	"Carrer de la Vinya"	"carretera"	"carretera"				
"Avinguda de l'Eix Central"	"Avinguda de l'Eix Central"	"carretera"	"carretera"				
"Carrer de la Font del Ferro"	"Carrer de la Font del Ferro"	"carrer de Nostra Senyora de Lourdes"	"carrer de Nostra Senyora de Lourdes"				
"Carrer Mare de Déu de Lourdes"	"Carrer Mare de Déu de Lourdes"	"carrer de Nostra Senyora de Lourdes"	"carrer de Nostra Senyora de Lourdes"				
"Carrer de la Mare de Déu de Lourdes"	"Carrer de la Mare de Déu de Lourdes"	"carrer de Nostra Senyora de Lourdes"	"carrer de Nostra Senyora de Lourdes"				
"camí de la Font del Moreu"	"camí de la Font del Moreu"	"Antic camí de les Martines a Can Guitard de la Riera"	"Antic camí de les Martines a Can Guitard de la Riera"				
"Llac d'en Miquel"	"Llac d'en Miquel"						
"Llac Escarransit"	"Llac Escarransit"						
"Llac de la Lola"	"Llac de la Lola"						
"Llac de la Pepa"	"Llac de la Pepa"						
"Pla de l'Argemira"	"Pla de l'Argemira"						
"Plaça d'Espanya"	"Plaça d'Espanya"	"plaça de les Palmeres"	"plaça de les Palmeres"				
"Plaça Espanya"	"Plaça Espanya"	"plaça de les Palmeres"	"plaça de les Palmeres"				
"Estany de la Roberta"	"Estany de la Roberta"						
"Carrer de la Puríssima"	"Carrer de la Puríssima"	"la Fillola de Dalt"	"la Fillola de Dalt"				
"carrer d'Enmig"	"carrer d'Enmig"	"Camí Reial"	"Camí Reial"				
"Platja Estanys"	"Platja Estanys"	"es Coto"	"es Coto"				
"Pla de Vallvanera"	"Pla de Vallvanera"						
"Pla de Sant Miguel"	"Pla de Sant Miquel"						
"Pla del Masot"	"Pla del Masot"						
"Pla d'en Girbau"	"Pla d'en Girbau"						
"Mas de Brusca"	"Mas de Brusca"	"la Masia de Brusca"	"la Masia de Brusca"				
"Camí dels Muntells"	"Camí dels Muntells"						
"estany de na Borges"	"estany de na Borges"	"Estany des Bisbe"	"Estany des Bisbe"				
"Pla de Can Girbau"	"Pla de Can Girbau"						
"Carreró de l'Església"	"Carreró de l'Església"	"el Carreró"	"el Carreró"				
"Passeig de la Badia"	"Passeig de la Badia"	"passeig Alfons XIII"	"passeig Alfons XIII"				
"Riu de Gallinera"	"Riu de Gallinera"						
"Pla del Zenon"	"Pla del Zenon"						
"carrer d'Olot"	"carrer d'Olot"	"Carretera d'Olot a Riudaura"	"Carretera d'Olot a Riudaura"				
"Carrer de la Marinada"	"Carrer de la Marinada"		"de la marinada"				
"Pla de la Fontsanta"	"Pla de la Fontsanta"						
"Pla de la Minga"	"Pla de la Minga"						
"Còrrec de Comunera"	"Còrrec de Comunera"						
"Còrrec de la Verneda"	"Còrrec de la Verneda"						
"Carrer Comarca del la Marina"	"Carrer Comarca del la Marina"						
"Carrer les Parres"	"Carrer les Parres"	"la Costereta de les Parres"	"la Costereta de les Parres"				
"Carrer Ferrer"	"Carrer Ferrer"	"carrer Nou"	"carrer Nou"				
"plaça de Jaume I"	"plaça de Jaume I"	"Plaça París"	"Plaça París"				
"Camí de S'Ermitori"	"Camí de S'Ermitori"	"camí de Muro"	"camí de Muro"				
"Carrer del Corb Marí"	"Carrer del Corb Marí"						
"Mas d'en Fermí"	"Mas d'en Fermí"	"cal Figuerola"	"cal Figuerola"				
"Plaça dels Països Catalans"	"Plaça dels Països Catalans"	"plaça de la Foneria"	"plaça de la Foneria"				
"Pla dels Forcs"	"Pla dels Forcs"	"els Quatre Camins"	"els Quatre Camins"				
"Pla de la Tomasa"	"Pla de la Tomasa"						
"Carrer de Mossèn Cinto Verdaguer"	"Carrer de Mossèn Cinto Verdaguer"	"carretera d'Igualada"	"carretera d'Igualada"				
"camí del Soler Botei"	"camí del Soler Botei"	"Camí a l'ermita de Sant Sebastià"	"Camí a l'ermita de Sant Sebastià"				
"Avinguda Quatre"	"Avinguda Quatre"	"avinguda 4"	"avinguda 4"				
"Pla d’en Sarrió"	"Pla d’en Sarrió"						
"Carrer del Bon Sol"	"Carrer del Bon Sol"	"camí de Can Campins"	"camí de Can Campins"				
