"name"	"name:ca"	"alt_name:ca"	"alt_name"	"translations"	"ca.wikipedia_page"	"wikidata_type"	"wikidata_id"
"Pla de l'Abellar"	"Pla de l'Abellar"						
"Pla de la Volta"	"Pla de la Volta"						
"Pla de Vilar"	"Pla de Vilar"						
"Pla de Talladures"	"Pla de Talladures"						
"Pla del Grau"	"Pla del Grau"						
"Pla de les Saleres"	"Pla de les Saleres"						
"Pla del Pinar"	"Pla del Pinar"						
"Pla del Llop"	"Pla del Llop"						
"Pla de Perol"	"Pla de Perol"						
"Pla dels Arbres"	"Pla dels Arbres"						
"Agulla del Giravolt"	"Agulla del Giravolt"						
"Agulla dels Pallers"	"Agulla dels Pallers"						
"Agulla dels Tres o CNT"	"Agulla dels Tres o CNT"						
"Agulla Petita"	"Agulla Petita"						
"Agulla del Sol Ponent"	"Agulla del Sol Ponent"						
"Agulla del Capdamunt"	"Agulla del Capdamunt"						
"Agulla dels Espeleòlegs"	"Agulla dels Espeleòlegs"						
"Agulla Pelada"	"Agulla Pelada"						
"Agulla del Contrafort"	"Agulla del Contrafort"						
"Agulla de Can Jorba"	"Agulla de Can Jorba"						
"Agulla del Castell"	"Agulla del Castell"						
"Agulla de la Tempestat"	"Agulla de la Tempestat"						
"Agulla dels Ossos"	"Agulla dels Ossos"						
"Agulla de la Carnavalada o dels Set"	"Agulla de la Carnavalada o dels Set"						
"Agulla Xica de la Miranda (Petitona)"	"Agulla Xica de la Miranda (Petitona)"						
"Agulla de les Heures"	"Agulla de les Heures"						
"Agulla del Cirerer"	"Agulla del Cirerer"						
"Agulla dels Cinc Passos"	"Agulla dels Cinc Passos"						
"Agulla de l'Arbret"	"Agulla de l'Arbret"						
"Agulla Podrida"	"Agulla Podrida"						
"Agulla Superior del Pas del Príncep"	"Agulla Superior del Pas del Príncep"						
"Agulla Fàcil"	"Agulla Fàcil"						
"Agulla de la Princesa"	"Agulla de la Princesa"						
"Agulla del Rei"	"Agulla del Rei"						
"Pla de Palau"	"Pla de Palau"						
"Palau Robert"	"Palau Robert"						
"Pla de la Garsa"	"Pla de la Garsa"						
"Pla del Palau-Consolat del Mar"	"Pla del Palau-Consolat del Mar"						
"Rec Comtal"	"Rec Comtal"						
"carrer obert"	"carrer obert"						
"Pla de la Boqueria"	"Pla de la Boqueria"						
"Pla de Palau"	"Pla de Palau"			"Pla de Palau"	"Pla de Palau"	"Wikimedia disambiguation page"	"Q28005029"
"Pla de Montbau"	"Pla de Montbau"						
"Pla de la Seu"	"Pla de la Seu"						
"Carrer de la Selva del Camp"	"Carrer de la Selva del Camp"	"carrer Fondal de Sant Martí"	"carrer Fondal de Sant Martí"				
"Pla de Sant Nicolau"	"Pla de Sant Nicolau"						
"Pla de Sant Miquel"	"Pla de Sant Miquel"						
"Rec del Clot de la Deu"	"Rec del Clot de la Deu"						
"Rec del Clot de la Coma"	"Rec del Clot de la Coma"						
"Rec de la Font de l'Arç"	"Rec de la Font de l'Arç"						
"Rec de la Tremoleda"	"Rec de la Tremoleda"						
"Rec del Corral"	"Rec del Corral"						
"Rec de la Font del Bac"	"Rec de la Font del Bac"	"Rec de la Font de Pedra"	"Rec de la Font de Pedra"				
"Rec de la Font del Rei"	"Rec de la Font del Rei"						
"Rec Fondo"	"Rec Fondo"	"Rec de la Font"	"Rec de la Font"				
"Rec de la Font dels Senyors"	"Rec de la Font dels Senyors"						
"Rec de la Penyora"	"Rec de la Penyora"						
"Rec de la Font de la Pedrera"	"Rec de la Font de la Pedrera"						
"Estany de Can Brugada"	"Estany de Can Brugada"						
"Rec de Can Coma"	"Rec de Can Coma"						
"Rec del Clot de Guixeres"	"Rec del Clot de Guixeres"	"Rec de la Caseta"	"Rec de la Caseta"				
"Rec de Cal Rei"	"Rec de Cal Rei"						
"Rec de Godall"	"Rec de Godall"						
"Rec de Mas Ventós"	"Rec de Mas Ventós"						
"Pla de les Escampades"	"Pla de les Escampades"						
"Pla dels Arços"	"Pla dels Arços"						
"Pla Traver"	"Pla Traver"						
"Pla de les Cavorques"	"Pla de les Cavorques"						
"Pla d'en Bosc"	"Pla d'en Bosc"						
"Pla Esquer"	"Pla Esquer"						
"Pla Falguera"	"Pla Falguera"						
"Pla d'Aiats"	"Pla d'Aiats"						
"Pla de les Soques"	"Pla de les Soques"						
"Pla de Falgars"	"Pla de Falgars"						
"Pla de Falgar"	"Pla de Falgar"						
"Pla Gran"	"Pla Gran"						
"Veïnat del Carrer"	"Veïnat del Carrer"						
"Pla de les Preses"	"Pla de les Preses"						
"Pla de la Pinya"	"Pla de la Pinya"						
"Rec dels Maials"	"Rec dels Maials"						
"Rec de les Olletes"	"Rec de les Olletes"						
"Rec d'en Vidal"	"Rec d'en Vidal"						
"Rec del Puig"	"Rec del Puig"						
"Rec de Terrús"	"Rec de Terrús"						
"Veïnat Nou"	"Veïnat Nou"						
"Pla de la Garsa"	"Pla de la Garsa"						
"Pla de la Barraca"	"Pla de la Barraca"						
"Pla de Barri"	"Pla de Barri"						
"Pla de l'Oncle"	"Pla de l'Oncle"						
"Pla de Capdevila"	"Pla de Capdevila"						
"Pla Fondo de Baix"	"Pla Fondo de Baix"						
"Pla Fondo de Dalt"	"Pla Fondo de Dalt"						
"Pla del Capellà"	"Pla del Capellà"						
"Pla del Calvari"	"Pla del Calvari"						
"Pla del Pi"	"Pla del Pi"						
"Pla dels Creixans"	"Pla dels Creixans"						
"Pla de la Moixernera"	"Pla de la Moixernera"						
"Pla Llosar"	"Pla Llosar"						
"Pla de Bronsa"	"Pla de Bronsa"						
"Rec de la Riba"	"Rec de la Riba"						
"Rec de Corbera"	"Rec de Corbera"						
"Rec de Robert"	"Rec de Robert"						
"Rec de Corrubí"	"Rec de Corrubí"						
"Pla d'en Plata"	"Pla d'en Plata"						
"Pla de la Guaitada"	"Pla de la Guaitada"						
"Pla de la Molina"	"Pla de la Molina"						
"Pla del Remei"	"Pla del Remei"						
"Pla de les Arques"	"Pla de les Arques"						
"Pla de Bonaire"	"Pla de Bonaire"						
"Pla d'en Sala"	"Pla d'en Sala"						
"Pla del Talló"	"Pla del Talló"						
"Pla de la Batalla"	"Pla de la Batalla"						
"Pla de la Corbera"	"Pla de la Corbera"						
"Pla de Rajada"	"Pla de Rajada"						
"Pla del Molí"	"Pla del Molí"						
"Pla dels Claus"	"Pla dels Claus"						
"Pla del Voltor"	"Pla del Voltor"						
"Pla de Falguers"	"Pla de Falguers"						
"Pla de la Primavera"	"Pla de la Primavera"						
"Pla de les Guillasses"	"Pla de les Guillasses"						
"Rec de la Font del Boix"	"Rec de la Font del Boix"						
"Rec d'en Cavats"	"Rec d'en Cavats"						
"Pla de l'Arç"	"Pla de l'Arç"						
"Pla de la Llacuna"	"Pla de la Llacuna"						
"Pla de les Dues Lliures"	"Pla de les Dues Lliures"						
"Pla de la Baga"	"Pla de la Baga"						
"Pla del Pedró"	"Pla del Pedró"						
"Pla de Rialb"	"Pla de Rialb"						
"Pla dels Evangelis"	"Pla dels Evangelis"						
"Agulla dels Arbrets"	"Agulla dels Arbrets"						
"Pla dels Anyells"	"Pla dels Anyells"						
"Pla de la Quera"	"Pla de la Quera"						
"Pla de les Fonts"	"Pla de les Fonts"						
"Agulla de l'Estany"	"Agulla de l'Estany"						
"Pla de les Barraques"	"Pla de les Barraques"						
"Pla de la Camamilla"	"Pla de la Camamilla"						
"Pla de Sallent"	"Pla de Sallent"						
"Pla Gran"	"Pla Gran"						
"Estany de Núria"	"Estany de Núria"			"Embassament de Núria"	"Embassament de Núria"	"lake"	"Q18005156"
"Pla de Solls"	"Pla de Solls"						
"Pla del Vi"	"Pla del Vi"						
"Pla de la Serra"	"Pla de la Serra"						
"Pla de les Borregues"	"Pla de les Borregues"						
"Pla de la Muga"	"Pla de la Muga"						
"Pla de la Guilla"	"Pla de la Guilla"						
"Pla del Vesc"	"Pla del Vesc"						
"Pla de la Bateria"	"Pla de la Bateria"						
"Pla de les Guixoles"	"Pla de les Guixoles"						
"Pla del Pare"	"Pla del Pare"						
"Pla d'Estanys"	"Pla d'Estanys"						
"Pla de la Teuleria"	"Pla de la Teuleria"						
"Pla del Caçador"	"Pla del Caçador"						
"Pla del Forn"	"Pla del Forn"						
"Pla de la Fou"	"Pla de la Fou"						
"Còrrec del Teix"	"Còrrec del Teix"						
"Pla d'en Just"	"Pla d'en Just"						
"Pla Rodó"	"Pla Rodó"						
"Pla de les Bigues"	"Pla de les Bigues"						
"Pla de la Regalíssia"	"Pla de la Regalíssia"						
"Pla de l'Avetosa"	"Pla de l'Avetosa"						
"Pla Xic"	"Pla Xic"						
"Pla de la Calma"	"Pla de la Calma"						
"Pla del Carlí"	"Pla del Carlí"						
"Pla del Racó"	"Pla del Racó"						
"Pla de Coma Ermada"	"Pla de Coma Ermada"						
"Pla Cominal"	"Pla Cominal"						
"Pla de Rebost"	"Pla de Rebost"						
"Pla de Carboners"	"Pla de Carboners"						
"Pla d'en Floretes"	"Pla d'en Floretes"						
"Estany dels Infants"	"Estany dels Infants"						
"Pla de l'Arc"	"Pla de l'Arc"						
"Pla de l`Arc"	"Pla de l`Arc"						
"Pla del Campament"	"Pla del Campament"						
"Carrer de Provença"	"Carrer de Provença"	"rambla de Llefià"	"rambla de Llefià"				
"Carrer de Pablo Picasso"	"Carrer de Pablo Picasso"	"carrer de Pau Picasso"	"carrer de Pau Picasso"				
"Carrer de Mossèn Anton Romeu"	"Carrer de Mossèn Anton Romeu"	"carrer d'en Mossèn Anton Romeu"	"carrer d'en Mossèn Anton Romeu"				
"Avinguda de Bac de Roda"	"Avinguda de Bac de Roda"	"pont del Torrent de la Font"	"pont del Torrent de la Font"				
"Llac romàntic"	"Llac romàntic"						
"Pla de les Pedres"	"Pla de les Pedres"						
"Llac i Cel"	"Llac i Cel"						
"Estany Rodó"	"Estany Rodó"					"lake"	"Q21330337"
"Estany d'Encamp"	"Estany d'Encamp"					"lake"	"Q21329514"
"Estany Moreno"	"Estany Moreno"					"lake"	"Q21330004"
"Estany de les Fonts"	"Estany de les Fonts"					"lake"	"Q21329687"
"Estany Rodó"	"Estany Rodó"					"lake"	"Q21330338"
"Estany de Coma Estremera"	"Estany de Coma Estremera"						
"Estany Forcat"	"Estany Forcat"						
"Estany Primer"	"Estany Primer"			"Estany Primer"		"lake"	"Q21330258"
"Estany de l'Illa"	"Estany de l'Illa"					"lake"	"Q21329797"
"Estany de Montmalús"	"Estany de Montmalús"					"lake"	"Q21329992"
"Pla del Toneu"	"Pla del Toneu"						
"Pla de la Noguera"	"Pla de la Noguera"						
"Pla de les Rovires"	"Pla de les Rovires"						
"Pla de les Eugues"	"Pla de les Eugues"						
"Pla de Vinya"	"Pla de Vinya"						
"Pla Guinard"	"Pla Guinard"						
"Pla de l'Om"	"Pla de l'Om"						
"Pla de Sant Roc"	"Pla de Sant Roc"						
"Pla del Fanal"	"Pla del Fanal"						
"Pla del Riquer"	"Pla del Riquer"						
"Rec de l'Esperança"	"Rec de l'Esperança"						
"Rec del Romeu"	"Rec del Romeu"						
"Rec de l'Argila"	"Rec de l'Argila"						
"pla de ses Figueres"	"pla de ses Figueres"						
"Pla des Conills"	"Pla des Conills"						
"Llac dels Cignes"	"Llac dels Cignes"						
"Plaça de Sant Francesc Xavier"	"Plaça de Sant Francesc Xavier"	"sa Pista"	"sa Pista"				
"Camí Fondo"	"Camí Fondo"	"camí vell de Llucmajor"	"camí vell de Llucmajor"				
"Camí 140 o de na Cerdana"	"Camí 140 o de na Cerdana"	"camí de na Cerdana"	"camí de na Cerdana"				
"Plaça dels Nins"	"Plaça dels Nins"	"plaça de les Copinyes"	"plaça de les Copinyes"				
"Pla del Castell"	"Pla del Castell"						
"Rec de Patiràs"	"Rec de Patiràs"						
"Rec de la Roqueta"	"Rec de la Roqueta"						
"Còrrec de Coma de Vaixell"	"Còrrec de Coma de Vaixell"						
"Rec de Sant Miquel"	"Rec de Sant Miquel"						
"Rec del Marquès"	"Rec del Marquès"						
"Rec del Dragó"	"Rec del Dragó"						
"Rec de la Falguera"	"Rec de la Falguera"						
"Rec del Socarrat"	"Rec del Socarrat"						
"Rec de Comes Llobes"	"Rec de Comes Llobes"						
"Rec de la Fonollera"	"Rec de la Fonollera"						
"Rec de Coma Fredosa"	"Rec de Coma Fredosa"						
"Rec de la Murtra"	"Rec de la Murtra"						
"Rec de la Pineda"	"Rec de la Pineda"						
"Estany de Sant Maurici (per la presa)"	"Estany de Sant Maurici (per la presa)"						
"Pla del Pui de Linya"	"Pla del Pui de Linya"						
"Estany del Ferro"	"Estany del Ferro"						
"Estany de Ratera"	"Estany de Ratera"						
"Estany Gelat"	"Estany Gelat"						
"Estany Gran de Peguera"	"Estany Gran de Peguera"						
"Estany de Llastra"	"Estany de Llastra"						
"Estany de la Coveta"	"Estany de la Coveta"						
"Estany Amagat"	"Estany Amagat"						
"Estany de la Bassa"	"Estany de la Bassa"						
"Estany de Lladres"	"Estany de Lladres"						
"Estany de la Llosa de Davall"	"Estany de la Llosa de Davall"						
"Estany 1"	"Estany 1"						
"Estany 2"	"Estany 2"						
"Estany 3"	"Estany 3"						
"Estany 4"	"Estany 4"						
"Pla de Can Marès"	"Pla de Can Marès"						
"Pla de les Gates"	"Pla de les Gates"						
"Pla de la Guardiola"	"Pla de la Guardiola"						
"Pla dels Sanços"	"Pla dels Sanços"						
"Pla de Can Causa"	"Pla de Can Causa"						
"Pla de les Taules"	"Pla de les Taules"						
"Rec Madral"	"Rec Madral"						
"Rec de la Murtra"	"Rec de la Murtra"						
"Rec de Montjoi"	"Rec de Montjoi"						
"Rec de Jóncols"	"Rec de Jóncols"						
"Rec de la Perafita"	"Rec de la Perafita"						
"Pla de la Beguda"	"Pla de la Beguda"						
"Pla de la Nit"	"Pla de la Nit"						
"Pla del Corral d'en Vidal"	"Pla del Corral d'en Vidal"						
"Pla de la Llet"	"Pla de la Llet"						
"Pla Socarrat"	"Pla Socarrat"						
"Pla de Sant Julià"	"Pla de Sant Julià"						
"Pla del Graners"	"Pla del Graners"						
"Pla de les Plateres"	"Pla de les Plateres"						
"Pla de la Tomba"	"Pla de la Tomba"						
"Pla de les Maduixes"	"Pla de les Maduixes"						
"Pla de les Barraques"	"Pla de les Barraques"						
"Pla de la Fosa"	"Pla de la Fosa"						
"Pla de les Bruixes"	"Pla de les Bruixes"						
"Pla de Borràs"	"Pla de Borràs"						
"Pla de Vaquers"	"Pla de Vaquers"						
"Pla de Jaques"	"Pla de Jaques"						
"Pla d'en Querol"	"Pla d'en Querol"						
"Pla del Bruc"	"Pla del Bruc"						
"Pla de les Solius"	"Pla de les Solius"						
"Pla Llacera"	"Pla Llacera"						
"Pla de Bassa Llacuna"	"Pla de Bassa Llacuna"						
"Pla d'en Ferris"	"Pla d'en Ferris"						
"Pla de Puig Moltó"	"Pla de Puig Moltó"						
"Pla del Rector"	"Pla del Rector"						
"Pla de Montau"	"Pla de Montau"						
"Pla del Cirerer"	"Pla del Cirerer"						
"Pla de Sots d'Óssos"	"Pla de Sots d'Óssos"						
"Pla de Begues"	"Pla de Begues"						
"Pla de Deulovol"	"Pla de Deulovol"						
"Pla des Estanyets"	"Pla des Estanyets"						
"Rec de Jóncols"	"Rec de Jóncols"						
"Rec de l'Espunya"	"Rec de l'Espunya"						
"Rec de sa Figuera"	"Rec de sa Figuera"						
"Rec de la Perafita"	"Rec de la Perafita"						
"Rec des Jonquet"	"Rec des Jonquet"						
"Rec de Cala Bona"	"Rec de Cala Bona"						
"Rec de Cala Torta"	"Rec de Cala Torta"						
"Rec de ses Culasses"	"Rec de ses Culasses"						
"Rec de Portaló"	"Rec de Portaló"						
"Rec de Cala d'Agulles"	"Rec de Cala d'Agulles"						
"Estany Gran de la Vall del Riu"	"Estany Gran de la Vall del Riu"						
"Estany dels Meners de la Coma"	"Estany dels Meners de la Coma"					"lake"	"Q21329944"
"Estany de Ransol"	"Estany de Ransol"						
"Estany Mort"	"Estany Mort"			"Estany Mort"		"glacial lake"	"Q21330009"
"Estany de Querol"	"Estany de Querol"					"lake"	"Q21330278"
"Estany Mort"	"Estany Mort"			"Estany Mort"		"glacial lake"	"Q21330008"
"Estany Gran de la Vall del Riu"	"Estany Gran de la Vall del Riu"					"lake"	"Q21328867"
"Estany de Cabana Sorda"	"Estany de Cabana Sorda"					"lake"	"Q21329206"
"Rec de Rocalba"	"Rec de Rocalba"						
"Rec de les Boixedes"	"Rec de les Boixedes"						
"Rec de la Nespleda"	"Rec de la Nespleda"						
"Pla del Bastons"	"Pla del Bastons"						
"Rec de Claperol"	"Rec de Claperol"						
"Rec del Puig Alt"	"Rec del Puig Alt"						
"Rec de Pedrosa"	"Rec de Pedrosa"						
"Rec dels Saiols"	"Rec dels Saiols"						
"Rec de Codolós"	"Rec de Codolós"						
"Rec de la Font Fresca"	"Rec de la Font Fresca"						
"Rec de Bosquerons"	"Rec de Bosquerons"						
"Rec de les Tombes"	"Rec de les Tombes"						
"Pla de Targarona"	"Pla de Targarona"						
"Pla de la Guàrdia"	"Pla de la Guàrdia"						
"Pla de les Moles"	"Pla de les Moles"						
"Pla dels Roures"	"Pla dels Roures"						
"Pla de Morelles"	"Pla de Morelles"						
"Pla de la Riera"	"Pla de la Riera"						
"Pla del Puig"	"Pla del Puig"						
"Pla de Puiggrony"	"Pla de Puiggrony"						
"Pla de Durà"	"Pla de Durà"						
"Pla d'en Salvi"	"Pla d'en Salvi"						
"Rec de Vallverd"	"Rec de Vallverd"						
"Rec de Torrent Generós"	"Rec de Torrent Generós"						
"Rec de la Sala"	"Rec de la Sala"						
"Rec del Bac del Coll"	"Rec del Bac del Coll"						
"Pla de Gibrella"	"Pla de Gibrella"						
"Pla Verdeguer"	"Pla Verdeguer"						
"Pla de Coll Joell"	"Pla de Coll Joell"						
"Rec de cab Tòfol"	"Rec de cab Tòfol"						
"Rec de les Clotes"	"Rec de les Clotes"						
"Rec de Serradell"	"Rec de Serradell"						
"Rec del Bertran"	"Rec del Bertran"						
"Rec de l'Aulet"	"Rec de l'Aulet"						
"Pla dels Pins de la Calàndria"	"Pla dels Pins de la Calàndria"						
"Pla de Sucs"	"Pla de Sucs"						
"Pla de les Torres"	"Pla de les Torres"						
"Pla de Raïmat"	"Pla de Raïmat"						
"Pla de les Casetes"	"Pla de les Casetes"						
"Pla del Baltasar"	"Pla del Baltasar"						
"Pla de Lleida"	"Pla de Lleida"						
"Pla d'Urgell"	"Pla d'Urgell"						
"Pla de Canelles"	"Pla de Canelles"						
"Pla del Davant"	"Pla del Davant"						
"Pla de l'Alzina del Consell"	"Pla de l'Alzina del Consell"						
"Pla dels Estudis"	"Pla dels Estudis"						
"Pla de la Casanova"	"Pla de la Casanova"						
"Pla del Pujol"	"Pla del Pujol"						
"Pla de la Batllia"	"Pla de la Batllia"						
"Pla de Davant"	"Pla de Davant"						
"Pla de Cal Ranci"	"Pla de Cal Ranci"						
"Pla dels Lladres"	"Pla dels Lladres"						
"Rec de Cerdanyola"	"Rec de Cerdanyola"						
"Rec de Passavant"	"Rec de Passavant"						
"Rec de les Cases"	"Rec de les Cases"						
"Rec de Bonaire"	"Rec de Bonaire"						
"Pla de Riba"	"Pla de Riba"						
"Pla del Mas d'en Soler"	"Pla del Mas d'en Soler"						
"Pla del Mas d'en Comte"	"Pla del Mas d'en Comte"						
"Pla de la Murtera"	"Pla de la Murtera"						
"Pla del curro"	"Pla del curro"						
"Pla de les Picades"	"Pla de les Picades"						
"Pla de l'Estadella"	"Pla de l'Estadella"						
"Pla de la Font Vella"	"Pla de la Font Vella"						
"Pla Pallarès"	"Pla Pallarès"						
"Pla d'en Bielet"	"Pla d'en Bielet"						
"Pla des Pou"	"Pla des Pou"						
"Pla des Vicari"	"Pla des Vicari"						
"Pla de Son Colomar"	"Pla de Son Colomar"						
"Pla des Pins"	"Pla des Pins"						
"Pla de ses Gatoves"	"Pla de ses Gatoves"						
"Pla de s'Aljub Gros"	"Pla de s'Aljub Gros"						
"Platja de La Romana"	"Platja de La Romana"	"platja dels Morts"	"platja dels Morts"	"platja de la Romana, platja dels Morts"		"white sand beach"	"Q107264672"
"Pla de Can Vera"	"Pla de Can Vera"						
"Rec de la Gallinera"	"Rec de la Gallinera"						
"Rec Madral"	"Rec Madral"						
"Rec d'en Bordes"	"Rec d'en Bordes"						
"Rec dels Salins"	"Rec dels Salins"						
"Llac de Sant Maurici"	"Llac de Sant Maurici"						
"Rec del Mig"	"Rec del Mig"						
"Estany del Tec"	"Estany del Tec"						
"Estany d'en Garrigoles"	"Estany d'en Garrigoles"						
"Pla de Sant Miquel"	"Pla de Sant Miquel"						
"Pla de Can Codina"	"Pla de Can Codina"						
"Pla del Sitjar"	"Pla del Sitjar"						
"Agulla de la Tuta"	"Agulla de la Tuta"						
"Pla de Rostoll"	"Pla de Rostoll"						
"Pla de Caselles"	"Pla de Caselles"						
"Pla del Prat"	"Pla del Prat"						
"Pla dels Sauris"	"Pla dels Sauris"						
"Veïnat de França"	"Veïnat de França"						
"Pla Jugar"	"Pla Jugar"						
"Pla de la Pomera"	"Pla de la Pomera"						
"Pla dels Pous"	"Pla dels Pous"						
"Pla de Formentor"	"Pla de Formentor"						
"Pla dels Ginebrons"	"Pla dels Ginebrons"						
"Pla de l'Espinal"	"Pla de l'Espinal"						
"Estany d'en Viada"	"Estany d'en Viada"						
"Pla de la Riba"	"Pla de la Riba"						
"Pla de Cartellà"	"Pla de Cartellà"						
"Pla d'en Carrió"	"Pla d'en Carrió"						
"Veïnat de l'Argelaguet"	"Veïnat de l'Argelaguet"						
"Veïnat de les Cases Noves"	"Veïnat de les Cases Noves"						
"Veïnat del Raval"	"Veïnat del Raval"						
"Veïnat Can Planes"	"Veïnat Can Planes"						
"Rec de Can Murtra"	"Rec de Can Murtra"						
"Veïnat de la Bruguera"	"Veïnat de la Bruguera"						
"Pla del Milà"	"Pla del Milà"						
"Còrrec de Coma Llobera"	"Còrrec de Coma Llobera"						
"Còrrec de la Calella"	"Còrrec de la Calella"						
"Còrrec del Falaguer"	"Còrrec del Falaguer"						
"Còrrec de la Cala Pedrosa"	"Còrrec de la Cala Pedrosa"						
"Còrrec de la Cala Ferriol"	"Còrrec de la Cala Ferriol"						
"Còrrec de les Tres Coves"	"Còrrec de les Tres Coves"						
"Còrrec Llarg"	"Còrrec Llarg"						
"Còrrec de la Caleta"	"Còrrec de la Caleta"						
"Pla del mas de Racó"	"Pla del mas de Racó"						
"Pla d'Amunt"	"Pla d'Amunt"						
"Pla de Vistabella"	"Pla de Vistabella"						
"Pla d'Avall"	"Pla d'Avall"						
"Pla de la Creu"	"Pla de la Creu"						
"Pla de les Batalles"	"Pla de les Batalles"						
"Pla del Ginestar"	"Pla del Ginestar"						
"Pla del Llamp"	"Pla del Llamp"						
"Pla de l'Estany"	"Pla de l'Estany"						
"Pla de l'Ase Mort"	"Pla de l'Ase Mort"						
"Pla de Sant Martí"	"Pla de Sant Martí"						
"Pla de la Castanyera"	"Pla de la Castanyera"						
"Pla de Cent Sous"	"Pla de Cent Sous"						
"Pla de la Selva"	"Pla de la Selva"						
"Pla de Llaguna"	"Pla de Llaguna"						
"Pla d'Arcalís"	"Pla d'Arcalís"						
"Pla de Baiau"	"Pla de Baiau"						
"Pla de Boet"	"Pla de Boet"						
"Estany de Baiau"	"Estany de Baiau"						
"Estany de Port de Boet"	"Estany de Port de Boet"						
"Pla del Sord"	"Pla del Sord"						
"Pla de Rascanya"	"Pla de Rascanya"						
"Pla de Torres"	"Pla de Torres"						
"Pla de Soca"	"Pla de Soca"						
"Pla de Morro"	"Pla de Morro"						
"Pla del Rullo"	"Pla del Rullo"						
"Pla de Ferrer"	"Pla de Ferrer"						
"Pla de Blai"	"Pla de Blai"						
"Pla de les Avenes"	"Pla de les Avenes"						
"Pla de les Avencs"	"Pla de les Avencs"						
"Pla del Sui"	"Pla del Sui"						
"Pla Aturat"	"Pla Aturat"						
"Pla Soliva de Dalt"	"Pla Soliva de Dalt"						
"Pla de la Roureda"	"Pla de la Roureda"						
"Pla  del Parany"	"Pla  del Parany"						
"Pla dels Évols"	"Pla dels Évols"						
"Pla de les Puces"	"Pla de les Puces"						
"Pla d'en Llops"	"Pla d'en Llops"						
"Pla de la Tronca"	"Pla de la Tronca"						
"Pla de la Font del Calvari"	"Pla de la Font del Calvari"						
"Pla d'en Mont"	"Pla d'en Mont"						
"Pla de Sant Andreu"	"Pla de Sant Andreu"						
"Pla de Dalt"	"Pla de Dalt"						
"Pla de Baix"	"Pla de Baix"						
"Pla de la Civadera"	"Pla de la Civadera"						
"Pla de Pendís"	"Pla de Pendís"						
"Pla de Fàbregues"	"Pla de Fàbregues"						
"Pla de la Palomera"	"Pla de la Palomera"						
"Pla de Corriol"	"Pla de Corriol"						
"Pla del Bellonc"	"Pla del Bellonc"						
"Pla dels Alemanys"	"Pla dels Alemanys"						
"Estany del Coll"	"Estany del Coll"						
"Pla de Miralpeix"	"Pla de Miralpeix"						
"Pla del Xup"	"Pla del Xup"						
"Pla de les Basses"	"Pla de les Basses"						
"Pla de les Llenties"	"Pla de les Llenties"						
"Pla dels Senyals"	"Pla dels Senyals"						
"Pla dels Vinyals"	"Pla dels Vinyals"						
"Pla de les Basses Roges"	"Pla de les Basses Roges"						
"Pla d'en Pitxot"	"Pla d'en Pitxot"						
"Avinguda de les Cases del Sord"	"Avinguda de les Cases del Sord"						
"Camí de la Creu de Ribes"	"Camí de la Creu de Ribes"						
"Pla de Lloses"	"Pla de Lloses"						
"Pla de la Castanyeda"	"Pla de la Castanyeda"						
"Pla de la Gavarrera"	"Pla de la Gavarrera"						
"Pla del Ginebre"	"Pla del Ginebre"						
"Pla del Barral"	"Pla del Barral"						
"Pla de Can Bosc"	"Pla de Can Bosc"						
"Pla Somera"	"Pla Somera"						
"Pla de Montfalcó"	"Pla de Montfalcó"						
"Pla Castellar"	"Pla Castellar"						
"Pla del Mas de Soses"	"Pla del Mas de Soses"						
"Pla de la Granja"	"Pla de la Granja"						
"Pla dels Conills"	"Pla dels Conills"						
"Pla dels Ametllers"	"Pla dels Ametllers"						
"Pla de la Cremada"	"Pla de la Cremada"						
"Pla de l'Argelaga"	"Pla de l'Argelaga"						
"Pla d'Argelaga"	"Pla d'Argelaga"						
"Pla de l'Alzina"	"Pla de l'Alzina"						
"Pla del Sifó"	"Pla del Sifó"						
"Pla del Puça"	"Pla del Puça"						
"Pla de Cúber"	"Pla de Cúber"						
"pla des Torrent"	"pla des Torrent"						
"Pla d'Almallutx"	"Pla d'Almallutx"						
"Agulla des Frare"	"Agulla des Frare"						
"pla des Clot de sa Neu"	"pla des Clot de sa Neu"						
"Pla de sa Creu"	"Pla de sa Creu"						
"Pla de sa Neu"	"Pla de sa Neu"						
"Pla des Verro"	"Pla des Verro"						
"Pla des Cards"	"Pla des Cards"						
"Pla de sa Font"	"Pla de sa Font"						
"Pla Negre"	"Pla Negre"						
"Pla de l'Àlber"	"Pla de l'Àlber"						
"Pla del Cucut"	"Pla del Cucut"						
"Pla del Vedellar"	"Pla del Vedellar"						
"Pla de la Corona"	"Pla de la Corona"						
"Pla de la Bassa"	"Pla de la Bassa"						
"Rec de la Font de les Enrocades"	"Rec de la Font de les Enrocades"						
"Rec de Muntanyola"	"Rec de Muntanyola"						
"Pla de la Ribera"	"Pla de la Ribera"						
"Pla de la Vaca"	"Pla de la Vaca"						
"Pla dels Verges"	"Pla dels Verges"						
"Pla dels Egües"	"Pla dels Egües"						
"Pla del Bou"	"Pla del Bou"						
"Pla dels Mates Velles"	"Pla dels Mates Velles"						
"pla de la Mata"	"pla de la Mata"						
"Pla de Coves Blanques"	"Pla de Coves Blanques"						
"Pla dels Hams"	"Pla dels Hams"						
"Pla de les Arenes"	"Pla de les Arenes"						
"Pla de las Basses"	"Pla de las Basses"						
"Pla de la Mata"	"Pla de la Mata"						
"Pla del Sastre"	"Pla del Sastre"						
"Rec de la Vinyola"	"Rec de la Vinyola"						
"Rec de la Casa"	"Rec de la Casa"						
"Rec de la Rovira"	"Rec de la Rovira"						
"Rec de les Fonts de Sora"	"Rec de les Fonts de Sora"						
"Pla Morell"	"Pla Morell"						
"Rec de les Tosques"	"Rec de les Tosques"						
"Rec de la Casanova"	"Rec de la Casanova"						
"Pla de Coromines"	"Pla de Coromines"						
"Pla dels Llobins"	"Pla dels Llobins"						
"Pla dels Termes"	"Pla dels Termes"						
"Pla de Cardons"	"Pla de Cardons"						
"Pla de la Llacuna"	"Pla de la Llacuna"						
"Pla dels Emprius"	"Pla dels Emprius"						
"Pla dels Trèmols"	"Pla dels Trèmols"						
"Pla del Sull"	"Pla del Sull"						
"Pla de Vallforners"	"Pla de Vallforners"						
"Veïnat de Viella"	"Veïnat de Viella"						
"Pla de Sant Esteve"	"Pla de Sant Esteve"						
"Pla de Galliners"	"Pla de Galliners"						
"Pla de Parets"	"Pla de Parets"						
"Pla de Can Casal"	"Pla de Can Casal"						
"Rec de la Torre"	"Rec de la Torre"						
"pla de la Creu"	"pla de la Creu"						
"Pla de la Creu"	"Pla de la Creu"						
"Pla de Valero"	"Pla de Valero"						
"Pla de la Lloma"	"Pla de la Lloma"						
"Pla de la Font"	"Pla de la Font"						
"Pla de Monet"	"Pla de Monet"						
"Estany Redó"	"Estany Redó"						
"Estany Llong"	"Estany Llong"						
"Estany de Bou"	"Estany de Bou"						
"Estany de Clavera"	"Estany de Clavera"						
"Estany Blau"	"Estany Blau"						
"Estany Pudo"	"Estany Pudo"						
"Pla de Cristòfol"	"Pla de Cristòfol"						
"Rec Nou"	"Rec Nou"						
"Pla de Sorells"	"Pla de Sorells"						
"Pla d'Aigües Vives"	"Pla d'Aigües Vives"						
"Pla de la Murta"	"Pla de la Murta"						
"Pla de Corbera"	"Pla de Corbera"						
"Llac Muralles d'Aigua"	"Llac Muralles d'Aigua"						
"Pla de l'Ingla"	"Pla de l'Ingla"						
"Pla de Nas"	"Pla de Nas"						
"Pla del Pedró"	"Pla del Pedró"						
"Pla de Pi"	"Pla de Pi"						
"Pla de Tomeu"	"Pla de Tomeu"						
"Pla de Talló"	"Pla de Talló"						
"Pla de Santa Maria"	"Pla de Santa Maria"						
"Pla de Salades"	"Pla de Salades"						
"Pla de les Vinyes"	"Pla de les Vinyes"						
"Pla de la Tia"	"Pla de la Tia"						
"Rec de la Creu"	"Rec de la Creu"						
"Pla de sa Coma"	"Pla de sa Coma"						
"Pla des Pou"	"Pla des Pou"						
"Pla des Ullastres"	"Pla des Ullastres"						
"Pla des Ciprer"	"Pla des Ciprer"						
"Pla dels Pins"	"Pla dels Pins"						
"Pla de sa Màquina"	"Pla de sa Màquina"						
"Pla des Bosc de Son Palou"	"Pla des Bosc de Son Palou"						
"Pla de sa Bassa"	"Pla de sa Bassa"						
"Pla des Bosc"	"Pla des Bosc"						
"Pla de s'Aigua"	"Pla de s'Aigua"						
"Pla de la Caseta"	"Pla de la Caseta"						
"Pla de les Forques"	"Pla de les Forques"						
"Pla Rubí"	"Pla Rubí"						
"Pla de Can Carabrut"	"Pla de Can Carabrut"						
"Pla de les Boixes"	"Pla de les Boixes"						
"Pla del Boix"	"Pla del Boix"						
"Pla des Marge"	"Pla des Marge"						
"Pla de s'Avenc"	"Pla de s'Avenc"						
"Pla de sa Vinya"	"Pla de sa Vinya"						
"Pla de s'Aljub"	"Pla de s'Aljub"						
"Pla Verd"	"Pla Verd"						
"Pla des Camí"	"Pla des Camí"						
"Pla de Sant Joan"	"Pla de Sant Joan"						
"Pla de les Someres"	"Pla de les Someres"						
"Pla de les Llates"	"Pla de les Llates"						
"Pla de la Molina"	"Pla de la Molina"						
"Pla dels Pallers"	"Pla dels Pallers"						
"Pla de les Penes"	"Pla de les Penes"						
"Pla de la Riba"	"Pla de la Riba"						
"Estany Petit de la Muga"	"Estany Petit de la Muga"						
"Estany Gran de la Muga"	"Estany Gran de la Muga"						
"Estany de Montmalús"	"Estany de Montmalús"					"lake"	"Q21329992"
"Pla Ferran"	"Pla Ferran"						
"Pla de Campllong"	"Pla de Campllong"						
"Estany de la Portella"	"Estany de la Portella"						
"Rec de Foguerades"	"Rec de Foguerades"						
"Rec de l'Àrtic"	"Rec de l'Àrtic"						
"Estany dels Minyons"	"Estany dels Minyons"						
"Estany Sec"	"Estany Sec"						
"Estany del Bull"	"Estany del Bull"						
"Estany Llarg"	"Estany Llarg"						
"Pla de les Deveses"	"Pla de les Deveses"						
"Pla de l'Abellera"	"Pla de l'Abellera"						
"Pla de les Freixes"	"Pla de les Freixes"						
"Pla de la Moleta"	"Pla de la Moleta"						
"Llac de la Roca Foradada"	"Llac de la Roca Foradada"						
"Pla dels Dois"	"Pla dels Dois"						
"Pla de la Pena"	"Pla de la Pena"						
"Pla del Freixe"	"Pla del Freixe"						
"Pla Freixes"	"Pla Freixes"						
"Pla de la Coma"	"Pla de la Coma"						
"Pla Antic"	"Pla Antic"						
"Pla d'Erola"	"Pla d'Erola"						
"Pla de les Basses de Baix"	"Pla de les Basses de Baix"						
"Pla de Cabanes"	"Pla de Cabanes"						
"Pla de les Basses de Dalt"	"Pla de les Basses de Dalt"						
"Pla del Sunyer"	"Pla del Sunyer"						
"Pla de la Devesa"	"Pla de la Devesa"						
"Pla de la Soca Negra"	"Pla de la Soca Negra"						
"Pla de l'Avenc"	"Pla de l'Avenc"						
"Pla Boixer"	"Pla Boixer"						
"Pla de les Fosses"	"Pla de les Fosses"						
"Rec de Mierons"	"Rec de Mierons"						
"Rec dels Escalars de les Balmes"	"Rec dels Escalars de les Balmes"						
"Rec de Can Casals"	"Rec de Can Casals"						
"Rec del Pontí"	"Rec del Pontí"						
"Pla de Verdú"	"Pla de Verdú"						
"Pla Mitjà"	"Pla Mitjà"						
"Pla de Tàrrega"	"Pla de Tàrrega"						
"Pla de Conill"	"Pla de Conill"						
"Pla de Sant Pere"	"Pla de Sant Pere"						
"Pla Llarg"	"Pla Llarg"						
"Pla de la Roca"	"Pla de la Roca"						
"Pla de Lluçà"	"Pla de Lluçà"						
"Pla de l'Agram"	"Pla de l'Agram"						
"Pla de sa Mola"	"Pla de sa Mola"						
"Pla de sa Moleta"	"Pla de sa Moleta"						
"Pla del Rei"	"Pla del Rei"						
"Pla des Avencs"	"Pla des Avencs"						
"pla dels Xots"	"pla dels Xots"						
"Pla dels Aritges"	"Pla dels Aritges"						
"Camí de ses Ermites Velles"	"Camí de ses Ermites Velles"	"camí del Bosc"	"camí del Bosc"				
"Pla de Sant Bernat"	"Pla de Sant Bernat"						
"Estany del Ravatxol"	"Estany del Ravatxol"						
"Estany del Pujol"	"Estany del Pujol"						
"Estany de la Panderola"	"Estany de la Panderola"						
"Pla de la Jaça"	"Pla de la Jaça"						
"Pla de Roques Blanques"	"Pla de Roques Blanques"						
"Pla de Pedrís"	"Pla de Pedrís"						
"Pla Llobet"	"Pla Llobet"						
"Pla de Palau"	"Pla de Palau"						
"Rec d'en Fitó"	"Rec d'en Fitó"						
"Rec de Fornells"	"Rec de Fornells"						
"Rec del Moro"	"Rec del Moro"						
"Rec del Portaló"	"Rec del Portaló"						
"Pla del Morro Negre"	"Pla del Morro Negre"						
"Pla Roig"	"Pla Roig"						
"Pla del Montnegre"	"Pla del Montnegre"						
"Pla de Corralets"	"Pla de Corralets"						
"Pla de l'Àliga"	"Pla de l'Àliga"						
"Pla de Cameta"	"Pla de Cameta"						
"Pla dels Rovellons"	"Pla dels Rovellons"						
"Pla de la Tallada"	"Pla de la Tallada"						
"Pla de Llenes"	"Pla de Llenes"						
"Pla dels Concos"	"Pla dels Concos"						
"Pla de Torre"	"Pla de Torre"						
"Pla de la Vinya"	"Pla de la Vinya"						
"Pla de cal Pau"	"Pla de cal Pau"						
"Pla de l'Escalivada"	"Pla de l'Escalivada"						
"Pla de s'Estany"	"Pla de s'Estany"						
"Pla de Tarragona"	"Pla de Tarragona"						
"pla sa Romana"	"pla sa Romana"						
"Pla des Caló"	"Pla des Caló"						
"Pla de ses Egües"	"Pla de ses Egües"						
"Pla de ses Bitles"	"Pla de ses Bitles"						
"pla de sa Romana"	"pla de sa Romana"						
"pla de ses Bitles"	"pla de ses Bitles"						
"estany de na Borges"	"estany de na Borges"	"Estany des Bisbe"	"Estany des Bisbe"				
"Pla de Santa Llogaia"	"Pla de Santa Llogaia"						
"Veïnat de Ca l'Ànima"	"Veïnat de Ca l'Ànima"						
"Pla de Can Ferran"	"Pla de Can Ferran"						
"Pla de Sords"	"Pla de Sords"						
"Pla de Pujals"	"Pla de Pujals"						
"Rec de les Estrades"	"Rec de les Estrades"						
"Rec de l'Abeurador"	"Rec de l'Abeurador"						
"Pla de l'Albi"	"Pla de l'Albi"						
"Pla de Joanet"	"Pla de Joanet"						
"Pla del Pòlit"	"Pla del Pòlit"						
"Pla del Teix"	"Pla del Teix"						
"Pla del Bassa"	"Pla del Bassa"						
"Pla del Portals"	"Pla del Portals"						
"Pla de la Torre Alta"	"Pla de la Torre Alta"						
"Pla de Casablanca"	"Pla de Casablanca"						
"Pla de Barrers"	"Pla de Barrers"						
"Pla de les Pletes"	"Pla de les Pletes"						
"Pla de les Ventoses"	"Pla de les Ventoses"						
"Pla de l'Era"	"Pla de l'Era"						
"Pla dels Mallols"	"Pla dels Mallols"						
"Pla de Fonolleres"	"Pla de Fonolleres"						
"Pla de la Carretera"	"Pla de la Carretera"						
"Pla dels Garrics"	"Pla dels Garrics"						
"Pla de l'Agulló"	"Pla de l'Agulló"						
"Pla de Moixeró"	"Pla de Moixeró"						
"Pla de l'Argelaguera"	"Pla de l'Argelaguera"						
"Pla Solà"	"Pla Solà"						
"Pla de Canells"	"Pla de Canells"						
"Pla d'Eroles"	"Pla d'Eroles"						
"Rec de la Teuleria"	"Rec de la Teuleria"						
"Rec de Montderm"	"Rec de Montderm"						
"Pla de Colomina"	"Pla de Colomina"						
"Pla de la Falguerona"	"Pla de la Falguerona"						
"Pla Perer"	"Pla Perer"						
"Pla de Ròssa"	"Pla de Ròssa"						
"Pla de l'Estiu"	"Pla de l'Estiu"						
"Pla de la Pastora"	"Pla de la Pastora"						
"Pla de Guinyoles"	"Pla de Guinyoles"						
"Pla de la Gana"	"Pla de la Gana"						
"Pla de les Fites"	"Pla de les Fites"						
"Pla de Mas Rodó"	"Pla de Mas Rodó"						
"Pla del Cementeri"	"Pla del Cementeri"						
"Pla de Mas d'en Ponç"	"Pla de Mas d'en Ponç"						
"Pla de Junyent"	"Pla de Junyent"						
"Pla de Can Griver"	"Pla de Can Griver"						
"Rec de la Font Pudosa"	"Rec de la Font Pudosa"						
"Rec del Pont d'en Carlina"	"Rec del Pont d'en Carlina"						
"Rec de la Font del Roure"	"Rec de la Font del Roure"						
"Rec de la Font del Nespler"	"Rec de la Font del Nespler"						
"Rec de l'Escaleta"	"Rec de l'Escaleta"						
"Rec del Regadiu"	"Rec del Regadiu"						
"Pla de la Colata"	"Pla de la Colata"						
"Passeig primer de maig"	"Passeig primer de maig"						
"Plaça d'Espanya"	"Plaça d'Espanya"						
"Carrer de Sant Blai"	"Carrer de Sant Blai"						
"Pla Moixó"	"Pla Moixó"						
"Pla del Soler"	"Pla del Soler"						
"Pla de la Senyora"	"Pla de la Senyora"						
"Pla del Roca"	"Pla del Roca"						
"Pla de l'Hedra"	"Pla de l'Hedra"						
"Pla d'en Pellisser"	"Pla d'en Pellisser"						
"Pla de Gallifa"	"Pla de Gallifa"						
"Pla de la Vila"	"Pla de la Vila"						
"Pla del Botines"	"Pla del Botines"						
"Pla de l'Astor"	"Pla de l'Astor"						
"Pla de la Pobla"	"Pla de la Pobla"						
"Pla del Lluc"	"Pla del Lluc"						
"Pla del Maset"	"Pla del Maset"						
"Veïnat del Mir"	"Veïnat del Mir"						
"Pla del Roure Gros"	"Pla del Roure Gros"						
"Pla de Teia"	"Pla de Teia"						
"Pla de Garrafa"	"Pla de Garrafa"						
"Pla d'en Xicoi"	"Pla d'en Xicoi"						
"Rec de Can Serra"	"Rec de Can Serra"						
"Rec del Collet"	"Rec del Collet"						
"Rec de les Fonts dels Ferrers"	"Rec de les Fonts dels Ferrers"						
"Pla dels Casals"	"Pla dels Casals"						
"Pla Sacot"	"Pla Sacot"						
"Pla del Coll de Caselles"	"Pla del Coll de Caselles"						
"Pla de Can Cabanya"	"Pla de Can Cabanya"						
"Pla de les Tries"	"Pla de les Tries"						
"Pla de Guilla"	"Pla de Guilla"						
"Pla de Pujolars"	"Pla de Pujolars"						
"Rec d'Olivella"	"Rec d'Olivella"						
"Pla Baguet"	"Pla Baguet"						
"Pla d'Anyella"	"Pla d'Anyella"						
"Pla de Fenal"	"Pla de Fenal"						
"Pla de la Moixa"	"Pla de la Moixa"						
"Pla de l'Orri de Dalt"	"Pla de l'Orri de Dalt"						
"Pla de les Salines de Baix"	"Pla de les Salines de Baix"						
"Pla de les Salines"	"Pla de les Salines"						
"Pla de Castelló"	"Pla de Castelló"						
"Pla de Sivina"	"Pla de Sivina"						
"Pla de Coma-rodona"	"Pla de Coma-rodona"						
"Pla de la Bronsa"	"Pla de la Bronsa"						
"Pla de la Torre"	"Pla de la Torre"						
"Pla de la Jaça Gran"	"Pla de la Jaça Gran"						
"Rec del Bac de Rònec"	"Rec del Bac de Rònec"						
"Pla de la Mola"	"Pla de la Mola"						
"Pla d'en Vaques"	"Pla d'en Vaques"						
"Pla del Cametes"	"Pla del Cametes"						
"Pla del Mas"	"Pla del Mas"						
"Pla de la Coma"	"Pla de la Coma"						
"Pla de la Creueta"	"Pla de la Creueta"						
"Pla de Quintanes"	"Pla de Quintanes"						
"Pla de Torroella"	"Pla de Torroella"						
"Pla de Masferrer"	"Pla de Masferrer"						
"Pla dels Erms"	"Pla dels Erms"						
"Pla de Brugueres"	"Pla de Brugueres"						
"Pla del Colomer"	"Pla del Colomer"						
"Pla de Casanoves"	"Pla de Casanoves"						
"Pla de Rems"	"Pla de Rems"						
"Rec de la Font del Serradal"	"Rec de la Font del Serradal"						
"Pla de Romer"	"Pla de Romer"						
"Pla de la Cerdanya"	"Pla de la Cerdanya"						
"Pla d'Agulló"	"Pla d'Agulló"						
"Pla del Lluís"	"Pla del Lluís"						
"Pla de les Llaurades"	"Pla de les Llaurades"						
"Pla de Moltó"	"Pla de Moltó"						
"Agulla del Forat"	"Agulla del Forat"						
"Pla des Broll"	"Pla des Broll"						
"Pla d'en Soldat"	"Pla d'en Soldat"						
"Pla de Son Forners"	"Pla de Son Forners"						
"Pla de s'Ordi"	"Pla de s'Ordi"						
"Pla des Vicari"	"Pla des Vicari"						
"pla des Salobre"	"pla des Salobre"						
"Pla de s'Evangèlica"	"Pla de s'Evangèlica"						
"Pla de Guardiola"	"Pla de Guardiola"						
"Pla d'Aguilar"	"Pla d'Aguilar"						
"Pla dels Pins Bons"	"Pla dels Pins Bons"						
"Pla de la Ferreria"	"Pla de la Ferreria"						
"Pla del Gener"	"Pla del Gener"						
"Pla de la Vall"	"Pla de la Vall"						
"Pla dels Quinze Diners"	"Pla dels Quinze Diners"						
"Pla de Can Surós"	"Pla de Can Surós"						
"Pla de Can Batlle"	"Pla de Can Batlle"						
"Pla de la Margenera"	"Pla de la Margenera"						
"Pla de Can Costa"	"Pla de Can Costa"						
"Pla de l'Abadia"	"Pla de l'Abadia"						
"Pla de Campanya"	"Pla de Campanya"						
"Pla de Recolta"	"Pla de Recolta"						
"Pla de Can Bellsolà"	"Pla de Can Bellsolà"						
"Estany de la Nou"	"Estany de la Nou"					"lake"	"Q21330043"
"Estany de Serramitjana"	"Estany de Serramitjana"					"lake"	"Q21330406"
"Estany Sec"	"Estany Sec"					"lake"	"Q21330386"
"Rec de l'Obac"	"Rec de l'Obac"						
"Rec d'Engordany"	"Rec d'Engordany"						
"Estany Blau"	"Estany Blau"					"lake"	"Q21330650"
"Estany Forcat"	"Estany Forcat"					"lake"	"Q21329697"
"Estany de la Bova"	"Estany de la Bova"					"lake"	"Q21329190"
"Pla de Sant Romà"	"Pla de Sant Romà"						
"Pla de Viu"	"Pla de Viu"						
"Pla de Pui de l'Anell"	"Pla de Pui de l'Anell"						
"Estany Gros"	"Estany Gros"						
"Estany Xic"	"Estany Xic"						
"Estany de la Ribereta de Baix"	"Estany de la Ribereta de Baix"						
"Estany Xic"	"Estany Xic"						
"Estany de Montarenyo"	"Estany de Montarenyo"						
"Estany Blau"	"Estany Blau"			"Estany Blau"	"Estany Blau"	"Wikimedia disambiguation page"	"Q53863890"
"Estany Blau de Dalt"	"Estany Blau de Dalt"						
"Rec del Mas Coromines"	"Rec del Mas Coromines"						
"Còrrec del Mas Coromines"	"Còrrec del Mas Coromines"						
"Rec del Llop"	"Rec del Llop"						
"Rec d'en Feliu"	"Rec d'en Feliu"						
"Rec de Grifeu"	"Rec de Grifeu"						
"Pla de Llodrà"	"Pla de Llodrà"						
"Pla des Seny"	"Pla des Seny"						
"Plaça de Ramon Llull"	"Plaça de Ramon Llull"	"plaça des Mercat"	"plaça des Mercat"				
"Carrer d'en Joan Lliteres"	"Carrer d'en Joan Lliteres"	"carrer de Ciutat"	"carrer de Ciutat"				
"Pla de Barrina"	"Pla de Barrina"						
"Pla del Pou"	"Pla del Pou"						
"Pla del Bosquetà"	"Pla del Bosquetà"						
"Pla de la Meuca"	"Pla de la Meuca"						
"Pla del Cavaller"	"Pla del Cavaller"						
"Pla de les Perdius"	"Pla de les Perdius"						
"Pla de l'Àliga. mirador Sud-Est"	"Pla de l'Àliga. mirador Sud-Est"						
"Pla de l'Àliga. mirador Nord-Est"	"Pla de l'Àliga. mirador Nord-Est"						
"Pla de la Vedella"	"Pla de la Vedella"						
"Pla de les Creus"	"Pla de les Creus"						
"Pla de la Clau"	"Pla de la Clau"						
"Rec de Cents"	"Rec de Cents"						
"Agulla de Mata-rodona"	"Agulla de Mata-rodona"						
"Agulla Superior del Gat Mesquer"	"Agulla Superior del Gat Mesquer"						
"Agulla del Gat Mesquer"	"Agulla del Gat Mesquer"						
"Agulla del coll de Garganta"	"Agulla del coll de Garganta"						
"Agulla del Centenari"	"Agulla del Centenari"						
"Pla de Serrallonga"	"Pla de Serrallonga"						
"Agulla el Barret 930 m"	"Agulla el Barret 930 m"						
"Agulla del Tap"	"Agulla del Tap"						
"Pla de Santa Eulàlia"	"Pla de Santa Eulàlia"						
"Pla de Fullà"	"Pla de Fullà"						
"Pla de Cal Llop"	"Pla de Cal Llop"						
"Pla de la Saleta"	"Pla de la Saleta"						
"Pla de Tàpies"	"Pla de Tàpies"						
"Pla de les Figueres"	"Pla de les Figueres"						
"Pla del Molí de la Roca"	"Pla del Molí de la Roca"						
"Pla del Cel"	"Pla del Cel"						
"Pla de la Pinassa"	"Pla de la Pinassa"						
"Pla de la Llosa"	"Pla de la Llosa"						
"Rec de la Tria"	"Rec de la Tria"						
"Pla d'en Sóller"	"Pla d'en Sóller"						
"Pla de sa Mola"	"Pla de sa Mola"						
"Pla de ses Llenties"	"Pla de ses Llenties"						
"Pla des Ossos"	"Pla des Ossos"						
"Pla de ses Cusses"	"Pla de ses Cusses"						
"Pla d'en Curt"	"Pla d'en Curt"						
"Pla de s'Argelaga"	"Pla de s'Argelaga"						
"Pla de Sobremunt"	"Pla de Sobremunt"						
"Pla d'en Vila"	"Pla d'en Vila"						
"Veïnat de Sant Medir"	"Veïnat de Sant Medir"						
"Pla  de Gelats"	"Pla  de Gelats"						
"Rec de la Brolla"	"Rec de la Brolla"						
"Pla de l'Olivera Alta"	"Pla de l'Olivera Alta"						
"Pla Olivera"	"Pla Olivera"						
"Pla Olivera I"	"Pla Olivera I"						
"Pla de la Lloma Rodona"	"Pla de la Lloma Rodona"						
"Pla de l'Olivera Baixa"	"Pla de l'Olivera Baixa"						
"Pla del Canvi"	"Pla del Canvi"						
"Pla d'Armadans"	"Pla d'Armadans"						
"Pla de Maià"	"Pla de Maià"						
"Rec de Sant Pau"	"Rec de Sant Pau"						
"Rec del Solanot"	"Rec del Solanot"						
"Estany d'Armadans"	"Estany d'Armadans"						
"Rec de la Masó"	"Rec de la Masó"						
"Pla de les Collades"	"Pla de les Collades"						
"Pla de la Fusta"	"Pla de la Fusta"						
"Rec de la Coromina"	"Rec de la Coromina"						
"Rec de Missa"	"Rec de Missa"						
"Rec de la Font del Sofre"	"Rec de la Font del Sofre"						
"Pla de la Qüestió"	"Pla de la Qüestió"						
"Pla de Valentí"	"Pla de Valentí"						
"Pla d'en Llima"	"Pla d'en Llima"						
"Pla de la Ruda"	"Pla de la Ruda"						
"Pla de la Figuera"	"Pla de la Figuera"						
"Pla d'en Bonet"	"Pla d'en Bonet"						
"Pla de la Carlina"	"Pla de la Carlina"						
"Pla de l'Ermita"	"Pla de l'Ermita"						
"Pla de la Molina"	"Pla de la Molina"						
"Estany de Mangades"	"Estany de Mangades"			"Estany de Mangades, estany de Mangades"	"Estany de Mangades"	"glacial lake"	"Q11920885"
"Estany del Port de Caldes"	"Estany del Port de Caldes"						
"Estany de la Roca"	"Estany de la Roca"						
"Pla de la Mata"	"Pla de la Mata"						
"Pla de Lima"	"Pla de Lima"						
"Pla d'en Palau"	"Pla d'en Palau"						
"Pla de la Sima"	"Pla de la Sima"						
"Pla de les Covetes"	"Pla de les Covetes"						
"Carrer de la Puríssima"	"Carrer de la Puríssima"	"la Fillola de Dalt"	"la Fillola de Dalt"				
"carrer d'Enmig"	"carrer d'Enmig"	"Camí Reial"	"Camí Reial"				
"Pla de la Baga"	"Pla de la Baga"						
"Pla del Cementiri"	"Pla del Cementiri"						
"Pla d'Alp"	"Pla d'Alp"						
"Pla dels Torradors"	"Pla dels Torradors"						
"Llac de la Molina"	"Llac de la Molina"						
"Llac de Prat Agre"	"Llac de Prat Agre"						
"Pla dels Matxos"	"Pla dels Matxos"						
"Veïnat de Sant Miquel del Cros"	"Veïnat de Sant Miquel del Cros"						
"Veïnat Cirés"	"Veïnat Cirés"						
"Llac de Can Comalada"	"Llac de Can Comalada"						
"Veïnat de Sant Jaume"	"Veïnat de Sant Jaume"						
"Pla de Vila-rasa"	"Pla de Vila-rasa"						
"Pla de Can Cavaller"	"Pla de Can Cavaller"						
"Pla de Martí"	"Pla de Martí"						
"Pla de Montcal"	"Pla de Montcal"						
"Pla d'Adri"	"Pla d'Adri"						
"Rec de Can Martí"	"Rec de Can Martí"						
"Rec de Can Cavaller"	"Rec de Can Cavaller"						
"Pla de sa Sínia"	"Pla de sa Sínia"						
"Pla d'en Xerro"	"Pla d'en Xerro"						
"Pla de Son Cerdà"	"Pla de Son Cerdà"						
"Pla de son Valls"	"Pla de son Valls"						
"Plaça d'Espanya"	"Plaça d'Espanya"	"plaça de les Palmeres"	"plaça de les Palmeres"				
"Plaça Espanya"	"Plaça Espanya"	"plaça de les Palmeres"	"plaça de les Palmeres"				
"Pla de la Cor"	"Pla de la Cor"						
"Rec del Solà"	"Rec del Solà"						
"Pla de l'Estany"	"Pla de l'Estany"						
"Estany Negre"	"Estany Negre"			"Estany Negre"		"glacial lake"	"Q1934789"
"Estany de les Truites"	"Estany de les Truites"			"Estany de les Truites"	"Estany de les Truites"	"glacial lake"	"Q2477261"
"Pla de la Clot"	"Pla de la Clot"						
"Estany Forcat"	"Estany Forcat"			"Estanys Forcats"	"Estanys Forcats"	"lake"	"Q2781227"
"Estany del Port Dret"	"Estany del Port Dret"					"lake"	"Q13579008"
"Pla de la Bassa del Llop"	"Pla de la Bassa del Llop"						
"Pla Marcell"	"Pla Marcell"						
"Pla de la Majordona"	"Pla de la Majordona"						
"Pla de Can Colomer"	"Pla de Can Colomer"						
"Pla de Can Tàpies"	"Pla de Can Tàpies"						
"Pla de Can Ferrer"	"Pla de Can Ferrer"						
"Pla Galí"	"Pla Galí"						
"Pla d'en Quera"	"Pla d'en Quera"						
"Pla Magre"	"Pla Magre"						
"Rec Comtal"	"Rec Comtal"						
"Pla de Rocamora"	"Pla de Rocamora"						
"Pla de Reixac"	"Pla de Reixac"						
"Pla d'Albinyana"	"Pla d'Albinyana"						
"Veïnat Colomer"	"Veïnat Colomer"						
"Pla d'en Miró"	"Pla d'en Miró"						
"Pla de l'Hospital"	"Pla de l'Hospital"						
"Pla de Manol"	"Pla de Manol"						
"Veïnat Muntaner"	"Veïnat Muntaner"						
"Pla de la Bomba"	"Pla de la Bomba"						
"Pla de Mallorca"	"Pla de Mallorca"						
"Pla de les Mentides"	"Pla de les Mentides"						
"Pla del Pèlag"	"Pla del Pèlag"						
"Pla del Molló"	"Pla del Molló"						
"Pla del Castelló"	"Pla del Castelló"						
"Pla del Tossal del Moro"	"Pla del Tossal del Moro"						
"Pla de Pujarnol"	"Pla de Pujarnol"						
"Pla de la Formiga"	"Pla de la Formiga"						
"Pla de Mata"	"Pla de Mata"						
"Pla de Can Morgat"	"Pla de Can Morgat"						
"Pla d'Usall"	"Pla d'Usall"						
"Pla del Pastor"	"Pla del Pastor"						
"Pla dels Arenals"	"Pla dels Arenals"						
"Pla del Cervo"	"Pla del Cervo"						
"Pla de Mora"	"Pla de Mora"						
"Pla de Corrals"	"Pla de Corrals"						
"pla dels Massacs"	"pla dels Massacs"						
"Pla dels Set Roures"	"Pla dels Set Roures"						
"Pla de la Bandera"	"Pla de la Bandera"						
"Pla de l'Home Mort"	"Pla de l'Home Mort"						
"Rec de la Rodonella"	"Rec de la Rodonella"						
"Pla d'en Terme"	"Pla d'en Terme"						
"Pla de les Medes"	"Pla de les Medes"						
"Pla de la Faja"	"Pla de la Faja"						
"Pla de Can Tura"	"Pla de Can Tura"						
"Pla del Salavedra"	"Pla del Salavedra"						
"Pla de Torlits"	"Pla de Torlits"						
"Pla dels Solers"	"Pla dels Solers"						
"Còrrec dels Pardalets"	"Còrrec dels Pardalets"						
"Còrrec de la Pixanera"	"Còrrec de la Pixanera"						
"Estany Petit dels Torlits"	"Estany Petit dels Torlits"						
"Estany Gran dels Torlits"	"Estany Gran dels Torlits"						
"Pla de la Collada"	"Pla de la Collada"						
"Pla de Casals"	"Pla de Casals"						
"Rec de Clarà"	"Rec de Clarà"						
"Rec de Can Panís"	"Rec de Can Panís"						
"Rec de Can Gorra"	"Rec de Can Gorra"						
"Pla de Sant Ponç"	"Pla de Sant Ponç"						
"Pla de les Caritats"	"Pla de les Caritats"						
"Pla de la Pineda"	"Pla de la Pineda"						
"Pla Vernet"	"Pla Vernet"						
"Pla d'en Pere"	"Pla d'en Pere"						
"Pla De l'Alzinar"	"Pla De l'Alzinar"						
"Pla de Terrades"	"Pla de Terrades"						
"Pla Rossell"	"Pla Rossell"						
"Pla de Les Qüestions"	"Pla de Les Qüestions"						
"Rec de Can Cuixa"	"Rec de Can Cuixa"						
"Rec d'Aigüespartides"	"Rec d'Aigüespartides"						
"Pla de la Llena"	"Pla de la Llena"						
"Pla d'Aragó"	"Pla d'Aragó"						
"Pla de la Caritat"	"Pla de la Caritat"						
"Pla de Nicolau"	"Pla de Nicolau"						
"Pla de Llac"	"Pla de Llac"						
"Pla d'Ardenya"	"Pla d'Ardenya"						
"Pla de la Jeia"	"Pla de la Jeia"						
"Pla del Lledoner"	"Pla del Lledoner"						
"Estany de l'Illa"	"Estany de l'Illa"						
"Estany del Remolar"	"Estany del Remolar"						
"Estany de la Magarola"	"Estany de la Magarola"						
"Estany de Cal Tet"	"Estany de Cal Tet"						
"Pla Sunyer de Carboners"	"Pla Sunyer de Carboners"						
"Pla Xoriguer"	"Pla Xoriguer"						
"Pla de l'Estanyol"	"Pla de l'Estanyol"						
"Pla de la Foia"	"Pla de la Foia"						
"Pla de Mallol"	"Pla de Mallol"						
"Pla del Savinar"	"Pla del Savinar"						
"Pla de Castellot"	"Pla de Castellot"						
"Pla de les Borges"	"Pla de les Borges"						
"Pla de les Alzines"	"Pla de les Alzines"						
"Pla dels Valls"	"Pla dels Valls"						
"Pla de Rufians"	"Pla de Rufians"						
"Pla del Portell"	"Pla del Portell"						
"Pla de les Punxes"	"Pla de les Punxes"						
"Pla de Batalla"	"Pla de Batalla"						
"Pla de Meanes"	"Pla de Meanes"						
"Pla de Barrot"	"Pla de Barrot"						
"Pla de Pagerols"	"Pla de Pagerols"						
"Pla de Sant Isidre"	"Pla de Sant Isidre"						
"Pla de la Perera"	"Pla de la Perera"						
"Llac de Graugés"	"Llac de Graugés"						
"Pla de Castellars"	"Pla de Castellars"						
"Pla de la Parada"	"Pla de la Parada"						
"Pla Bruguer"	"Pla Bruguer"						
"Pla de la Cabrera"	"Pla de la Cabrera"						
"Pla de Balenyà"	"Pla de Balenyà"						
"Rec de la Font Tordera"	"Rec de la Font Tordera"						
"Pla de Son Ric"	"Pla de Son Ric"						
"Veïnat de Escoles Velles"	"Veïnat de Escoles Velles"						
"Pla de Can Garriga"	"Pla de Can Garriga"						
"Pla de Ca l'Arboçar"	"Pla de Ca l'Arboçar"						
"Pla de Solls (indicació a un arbre)"	"Pla de Solls (indicació a un arbre)"						
"Pla de Malveí"	"Pla de Malveí"						
"Pla del Hereu"	"Pla del Hereu"						
"Pla de Colom"	"Pla de Colom"						
"Pla del Coscollar"	"Pla del Coscollar"						
"Pla d'Andanes"	"Pla d'Andanes"						
"Pla de Camós"	"Pla de Camós"						
"Veïnat de Can Pedrers"	"Veïnat de Can Pedrers"						
"Rec de Can Mateu"	"Rec de Can Mateu"						
"Rec de Cal Fuster"	"Rec de Cal Fuster"						
"Rec de la Torre"	"Rec de la Torre"						
"Pla de Molar"	"Pla de Molar"						
"Pla Teranyines"	"Pla Teranyines"						
"Pla de les Caves"	"Pla de les Caves"						
"Pla de les Caves de Baix"	"Pla de les Caves de Baix"						
"Pla del Pinell"	"Pla del Pinell"						
"Pla de Palol"	"Pla de Palol"			"Vil·la romana de Pla de Palol, vil·la romana de Pla de Palol"	"Vil·la romana de Pla de Palol"	"Roman archaeological site"	"Q11954829"
"Llac de les Galeries Neptú"	"Llac de les Galeries Neptú"						
"Llac d'aventures"	"Llac d'aventures"						
"Pla del Maquis"	"Pla del Maquis"						
"Pla dels Manresans"	"Pla dels Manresans"						
"Pla de Camps"	"Pla de Camps"						
"Pla de la Llauna"	"Pla de la Llauna"						
"Pla de Montconill"	"Pla de Montconill"						
"Pla d'en Figueres"	"Pla d'en Figueres"						
"Pla de la Creueta"	"Pla de la Creueta"						
"Pla de Campdorà"	"Pla de Campdorà"						
"Passeig d'Olot"	"Passeig d'Olot"						
"Agulla Vista"	"Agulla Vista"						
"Agulla del Miracle"	"Agulla del Miracle"						
"Pla de les Pinasses"	"Pla de les Pinasses"						
"Pla dels Arbrets"	"Pla dels Arbrets"						
"Pla de la Teula"	"Pla de la Teula"						
"Pla de Sant Llorenç"	"Pla de Sant Llorenç"						
"Pla dels Escorpins"	"Pla dels Escorpins"						
"Agulla del Fus"	"Agulla del Fus"						
"Pla o Coll dels Ginebrons o Ginebres"	"Pla o Coll dels Ginebrons o Ginebres"						
"Pla dels Ocells"	"Pla dels Ocells"						
"Pla de la Trinitat"	"Pla de la Trinitat"						
"Agulla Perduda"	"Agulla Perduda"						
"Agulla de la Verge"	"Agulla de la Verge"						
"Agulla del Riu"	"Agulla del Riu"						
"Pla de la Forca"	"Pla de la Forca"						
"Pla de l'Os"	"Pla de l'Os"						
"Pla del Cap Blanc"	"Pla del Cap Blanc"						
"Pla de l'Abat"	"Pla de l'Abat"						
"Pla de Bona Guia"	"Pla de Bona Guia"						
"Pla del Pegot"	"Pla del Pegot"						
"Pla del Monestir"	"Pla del Monestir"						
"Pla de Bòria"	"Pla de Bòria"						
"Pla de Vila-Seca"	"Pla de Vila-Seca"						
"Pla de Vila-seca"	"Pla de Vila-seca"						
"Pla de la Font de l'Horta"	"Pla de la Font de l'Horta"						
"Pla de Sant Genís"	"Pla de Sant Genís"						
"Pla de Mas Tortós"	"Pla de Mas Tortós"						
"Pla de Palafolls"	"Pla de Palafolls"						
"Rec de la Mina d'en Puig"	"Rec de la Mina d'en Puig"						
"Rec Viver"	"Rec Viver"						
"Pla de la Sorra"	"Pla de la Sorra"						
"Pla del Gorg"	"Pla del Gorg"						
"Pla de Cases"	"Pla de Cases"						
"Pla de l'Orri Vell"	"Pla de l'Orri Vell"						
"Pla d'en Rol"	"Pla d'en Rol"						
"Rec del Pedregar"	"Rec del Pedregar"						
"Còrrec de l'Ametller"	"Còrrec de l'Ametller"						
"Rec del Girau"	"Rec del Girau"						
"Pla del Fideu"	"Pla del Fideu"						
"Pla del Bisbe"	"Pla del Bisbe"						
"Pla dels Aladerns"	"Pla dels Aladerns"						
"Pla de Fornells"	"Pla de Fornells"						
"Pla de Costoja"	"Pla de Costoja"						
"Pla d'Elena"	"Pla d'Elena"						
"Pla de les Guilles"	"Pla de les Guilles"						
"Rec de les Clavegueres"	"Rec de les Clavegueres"						
"Rec del Mal Bosc"	"Rec del Mal Bosc"						
"Rec de Sant Quirc"	"Rec de Sant Quirc"						
"Rec de l'Auleda"	"Rec de l'Auleda"						
"Pla de Ramona"	"Pla de Ramona"						
"Pla del Corretger"	"Pla del Corretger"						
"Pla de Maresme"	"Pla de Maresme"						
"Pla de Fenc"	"Pla de Fenc"						
"Pla de Mataró"	"Pla de Mataró"						
"Pla de Banyadors"	"Pla de Banyadors"						
"Pla de Freixenet"	"Pla de Freixenet"						
"Pla de Fangals"	"Pla de Fangals"						
"Pla de la Tramuntana"	"Pla de la Tramuntana"						
"Rec de la Tuta"	"Rec de la Tuta"						
"Rec de Rimbau"	"Rec de Rimbau"						
"Rec de Vilaró"	"Rec de Vilaró"						
"Rec dels Solans"	"Rec dels Solans"						
"Rec del Vilar"	"Rec del Vilar"						
"Pla de l'Escolà"	"Pla de l'Escolà"						
"Pla de Gallardes"	"Pla de Gallardes"						
"Pla del Moliner"	"Pla del Moliner"						
"Pla de Flix"	"Pla de Flix"						
"Pla dels Estels"	"Pla dels Estels"						
"Camí dels Esquirols"	"Camí dels Esquirols"						
"Camí del Romaní"	"Camí del Romaní"						
"Camí del Roure Tombat"	"Camí del Roure Tombat"						
"Pla del Mallol"	"Pla del Mallol"						
"Pla d'en Via"	"Pla d'en Via"						
"Pla del Montpedrós"	"Pla del Montpedrós"						
"Pla de Pinós"	"Pla de Pinós"						
"Pla de les Alforges"	"Pla de les Alforges"						
"Pla d'Embadallar"	"Pla d'Embadallar"						
"Pla de l'Hostal"	"Pla de l'Hostal"						
"Pla de l'Artiga"	"Pla de l'Artiga"						
"Pla dels Fangars"	"Pla dels Fangars"						
"Pla del Toro"	"Pla del Toro"						
"Pla de la Pedrera"	"Pla de la Pedrera"						
"Pla de la Olivera"	"Pla de la Olivera"						
"Pla de Mula"	"Pla de Mula"						
"Pla del Boig"	"Pla del Boig"						
"Pla del Bonaire"	"Pla del Bonaire"						
"camí de la Font del Moreu"	"camí de la Font del Moreu"	"Antic camí de les Martines a Can Guitard de la Riera"	"Antic camí de les Martines a Can Guitard de la Riera"				
"Pla de la Guitard"	"Pla de la Guitard"						
"Pla del Garrot"	"Pla del Garrot"						
"Pla de la Rovira"	"Pla de la Rovira"						
"Pla de Sant Sebastià"	"Pla de Sant Sebastià"						
"Pla del Puntí"	"Pla del Puntí"						
"Pla de Torrenegra"	"Pla de Torrenegra"						
"rec de Fontanelles"	"rec de Fontanelles"						
"Pla la Sala"	"Pla la Sala"						
"Estany Gran"	"Estany Gran"						
"Estany Fe"	"Estany Fe"						
"Estany Negre"	"Estany Negre"						
"Pla de la Cova"	"Pla de la Cova"						
"Pla del Bord"	"Pla del Bord"						
"Pla d'Os"	"Pla d'Os"						
"Pla del Garriguer"	"Pla del Garriguer"						
"Pla dels Aires"	"Pla dels Aires"						
"Pla de Saragossa"	"Pla de Saragossa"						
"Pla de Falç"	"Pla de Falç"						
"Pla d'Almacelles"	"Pla d'Almacelles"						
"Pla del Tossalet"	"Pla del Tossalet"						
"Pla de Fenollet"	"Pla de Fenollet"						
"Pla del Sot"	"Pla del Sot"						
"Pla del Sas"	"Pla del Sas"						
"Rec de Serrallonga"	"Rec de Serrallonga"						
"Pla de Marcovau"	"Pla de Marcovau"						
"Pla de Sant Tirs"	"Pla de Sant Tirs"						
"Pla de Montargull"	"Pla de Montargull"						
"Pla del Camats"	"Pla del Camats"						
"Pla de les Dogues"	"Pla de les Dogues"						
"Pla de Querol"	"Pla de Querol"						
"Pla de Calaf"	"Pla de Calaf"						
"Pla del Nen"	"Pla del Nen"						
"Pla del Coll"	"Pla del Coll"						
"Pla de Sobirana"	"Pla de Sobirana"						
"Pla de Vilamajor"	"Pla de Vilamajor"						
"Pla de Montserrat"	"Pla de Montserrat"						
"Pla del Rabassot"	"Pla del Rabassot"						
"Pla de l'Assagador"	"Pla de l'Assagador"						
"Pla de Montfullà"	"Pla de Montfullà"						
"Pla del Ter"	"Pla del Ter"						
"rec Monar"	"rec Monar"						
"Pla de Bàscara"	"Pla de Bàscara"						
"Pla de Calabuig"	"Pla de Calabuig"						
"Pla d'Espolla"	"Pla d'Espolla"						
"Pla d'en Cuca"	"Pla d'en Cuca"						
"Rec de Mas d'Espolla"	"Rec de Mas d'Espolla"						
"Pla de Grau"	"Pla de Grau"						
"Pla de Reus"	"Pla de Reus"						
"Pla de la Cova de L'Aigua"	"Pla de la Cova de L'Aigua"						
"Pla de Galiana"	"Pla de Galiana"						
"Pla de Rus"	"Pla de Rus"						
"Pla de la Gran Jaça"	"Pla de la Gran Jaça"						
"Rec de la Garganta"	"Rec de la Garganta"						
"Rec de les Barres"	"Rec de les Barres"						
"Rec de les Omes"	"Rec de les Omes"						
"Pla de les Ginesteres"	"Pla de les Ginesteres"						
"Pla de les Bateries"	"Pla de les Bateries"						
"Agulla Tranquil·la"	"Agulla Tranquil·la"						
"Agulla de Sant Joan"	"Agulla de Sant Joan"						
"Pla de les Taràntules"	"Pla de les Taràntules"						
"Pla de Sant Miquel o dels Soldats"	"Pla de Sant Miquel o dels Soldats"						
"Pla de l'Espina"	"Pla de l'Espina"						
"Pla del Garet"	"Pla del Garet"						
"Pla de Mas Bastó"	"Pla de Mas Bastó"						
"Pla de Can Regàs"	"Pla de Can Regàs"						
"Pla del Sabater"	"Pla del Sabater"						
"Pla de Sabater"	"Pla de Sabater"						
"Pla de la Torreta"	"Pla de la Torreta"						
"Pla de s'Hort"	"Pla de s'Hort"						
"Pla de s'Ermita Vella"	"Pla de s'Ermita Vella"						
"pla des Murtar"	"pla des Murtar"						
"Pla de ses Tanques"	"Pla de ses Tanques"						
"Pla de Xeixa"	"Pla de Xeixa"						
"Pla des Born"	"Pla des Born"						
"Pla de Sant Pau"	"Pla de Sant Pau"						
"Rec Arnau"	"Rec Arnau"						
"Pla dels Hostalets"	"Pla dels Hostalets"						
"Rec del Mal Pas"	"Rec del Mal Pas"						
"Rec de Santa Susanna"	"Rec de Santa Susanna"						
"Rec de la Calçada"	"Rec de la Calçada"						
"Pla dels Cóms"	"Pla dels Cóms"						
"Pla dels Coms"	"Pla dels Coms"						
"Pla d'Escadarcs"	"Pla d'Escadarcs"						
"Pla de Soriguera"	"Pla de Soriguera"						
"Pla de Feners"	"Pla de Feners"						
"Rec del Coll de l'Arç"	"Rec del Coll de l'Arç"						
"Rec de les Viles Grosses"	"Rec de les Viles Grosses"						
"Rec de les Deveses"	"Rec de les Deveses"						
"Pla de la Sorda"	"Pla de la Sorda"						
"Pla de Pineda"	"Pla de Pineda"						
"Pla de la Verneda"	"Pla de la Verneda"						
"Pla de Castellnou"	"Pla de Castellnou"						
"Pla de les Cases"	"Pla de les Cases"						
"Pla Romaní"	"Pla Romaní"						
"Pla dels Olivars"	"Pla dels Olivars"						
"Estany del Mig"	"Estany del Mig"					"lake"	"Q21329955"
"Estany Primer"	"Estany Primer"			"Estany Primer"		"lake"	"Q21330260"
"Estany Esbalçat"	"Estany Esbalçat"					"lake"	"Q21329550"
"Estany de Més Amunt"	"Estany de Més Amunt"					"lake"	"Q21329949"
"Pla dels Coloms"	"Pla dels Coloms"						
"Pla de l'Argilaga"	"Pla de l'Argilaga"						
"Pla de la Basseta"	"Pla de la Basseta"						
"Pla del Pebret"	"Pla del Pebret"						
"Pla del Barranquet"	"Pla del Barranquet"						
"Estany del Port"	"Estany del Port"						
"Pla de Sant Marc"	"Pla de Sant Marc"						
"Pla d'Age"	"Pla d'Age"						
"Pla d'Enveig"	"Pla d'Enveig"						
"Pla de Rigolisa"	"Pla de Rigolisa"						
"Estany del Torniquet"	"Estany del Torniquet"						
"Pla des Abadals"	"Pla des Abadals"						
"Pla de Bages"	"Pla de Bages"						
"Pla de la Sala"	"Pla de la Sala"						
"Pla de Puigdorca"	"Pla de Puigdorca"						
"Pla del Bruguer"	"Pla del Bruguer"						
"Pla de Corbatera"	"Pla de Corbatera"						
"Pla Saiol"	"Pla Saiol"						
"Pla de la Capella"	"Pla de la Capella"						
"Llac dels Refugis"	"Llac dels Refugis"						
"Pla de Badina"	"Pla de Badina"						
"carrer Nicolau Primitiu"	"carrer Nicolau Primitiu"		"Calle de Nicolau Primitiu"				
"carrer Bernat Ramon"	"carrer Bernat Ramon"		"Calle del Cronista Granell"				
"carrer Cronista Ribelles"	"carrer Cronista Ribelles"		"Calle del Cronista Ribelles"				
"Pla de ses Basses"	"Pla de ses Basses"						
"Pla d'en Bieleta"	"Pla d'en Bieleta"						
"Pla d'en Mateu"	"Pla d'en Mateu"						
"Pla de la Bronza"	"Pla de la Bronza"						
"Pla de Paler"	"Pla de Paler"						
"Pla de Comtes"	"Pla de Comtes"						
"Rec dels Roures"	"Rec dels Roures"						
"Pla de Vidreres"	"Pla de Vidreres"						
"Pla del Galliner"	"Pla del Galliner"						
"Pla de Malloles"	"Pla de Malloles"						
"Rec Clar"	"Rec Clar"						
"Rec de Prat de Vedella"	"Rec de Prat de Vedella"						
"Pla d'Aguiló"	"Pla d'Aguiló"						
"Pla de Matamoros"	"Pla de Matamoros"						
"Pla de Brunet"	"Pla de Brunet"						
"Pla del Corral"	"Pla del Corral"						
"Estany de la Font de la Serra"	"Estany de la Font de la Serra"						
"Pla de la Balma"	"Pla de la Balma"						
"Pla del Grèvol"	"Pla del Grèvol"						
"Pla del Fum"	"Pla del Fum"						
"Pla del Saqueta"	"Pla del Saqueta"						
"Pla del Torro"	"Pla del Torro"						
"Pla del Meloner"	"Pla del Meloner"						
"Pla de la Marta"	"Pla de la Marta"						
"Pla de la Cantera"	"Pla de la Cantera"						
"Pla del Puig de Marc"	"Pla del Puig de Marc"						
"Pla de la Magina"	"Pla de la Magina"						
"Pla de l'Alzina Vella"	"Pla de l'Alzina Vella"						
"Pla del Rispa"	"Pla del Rispa"						
"Pla de les Garses"	"Pla de les Garses"						
"Pla de la Manxa"	"Pla de la Manxa"						
"Pla de Barberà"	"Pla de Barberà"						
"Pla de Tapioles"	"Pla de Tapioles"						
"Pla del Guilar"	"Pla del Guilar"						
"Pla de Redon"	"Pla de Redon"						
"Pla de Peres"	"Pla de Peres"						
"Pla de les Calderes"	"Pla de les Calderes"						
"Estany de Montcortès i Bosc Encantat"	"Estany de Montcortès i Bosc Encantat"						
"Pla de Ramos"	"Pla de Ramos"						
"Pla de les Muletes"	"Pla de les Muletes"						
"Pla dels Bous"	"Pla dels Bous"						
"Pla de Tarambana"	"Pla de Tarambana"						
"Pla de la Deu"	"Pla de la Deu"						
"Pla de l'Angle"	"Pla de l'Angle"						
"Camí del Cargolaire"	"Camí del Cargolaire"						
"Pla d'en Moragues"	"Pla d'en Moragues"						
"Pla de Catalina"	"Pla de Catalina"						
"Pla Sant Roc"	"Pla Sant Roc"						
"Pla de la Cresta"	"Pla de la Cresta"						
"Pla del Poll"	"Pla del Poll"						
"Pla de l'Arrupit"	"Pla de l'Arrupit"						
"Carrer de la Vinya"	"Carrer de la Vinya"	"carretera"	"carretera"				
"Avinguda de l'Eix Central"	"Avinguda de l'Eix Central"	"carretera"	"carretera"				
"Pla de Centelles"	"Pla de Centelles"						
"Pla de Raquel"	"Pla de Raquel"						
"Pla de Maria"	"Pla de Maria"						
"Pla de Sant Gabriel"	"Pla de Sant Gabriel"						
"Pla del Camp"	"Pla del Camp"						
"Pla del Simeó"	"Pla del Simeó"						
"Pla de Sant Gregori"	"Pla de Sant Gregori"						
"Veïnat de Planils"	"Veïnat de Planils"						
"Pla de Rupit"	"Pla de Rupit"						
"Pla d'Ini"	"Pla d'Ini"						
"Pla de l'Estel"	"Pla de l'Estel"						
"Pla de Cal Xic"	"Pla de Cal Xic"						
"Pla de Cal Pinyol"	"Pla de Cal Pinyol"						
"Pla de Can Mitjans"	"Pla de Can Mitjans"						
"Pla de l'Avellà"	"Pla de l'Avellà"						
"Pla del Joncar"	"Pla del Joncar"						
"Pla de la Bruguera"	"Pla de la Bruguera"						
"Pla de l'Oriol"	"Pla de l'Oriol"						
"Pla de Fontcoberta"	"Pla de Fontcoberta"						
"Pla del Descàrrec"	"Pla del Descàrrec"						
"Pla de la Revetlla"	"Pla de la Revetlla"						
"Pla d'en Rovira"	"Pla d'en Rovira"						
"Pla de la Mina"	"Pla de la Mina"						
"Pla d'en Panarra"	"Pla d'en Panarra"						
"Agulla Frare de la Vall"	"Agulla Frare de la Vall"						
"Pla de la Senyoria"	"Pla de la Senyoria"						
"Mas de Xalamera"	"Mas de Xalamera"						
"Pla del Campament"	"Pla del Campament"						
"Pla d'en Vidal"	"Pla d'en Vidal"						
"Pla de Penedes"	"Pla de Penedes"						
"Pla de la Sínia"	"Pla de la Sínia"						
"Pla de la Moreta"	"Pla de la Moreta"						
"Pla de Gelabert"	"Pla de Gelabert"						
"Pla de Can Caseta"	"Pla de Can Caseta"						
"Pla de Can Becaina"	"Pla de Can Becaina"						
"Pla Jugador"	"Pla Jugador"						
"Pla Joan"	"Pla Joan"						
"Pla de la Bena"	"Pla de la Bena"						
"Pla d'en Burguera"	"Pla d'en Burguera"						
"Pla de Santa Bàrbara"	"Pla de Santa Bàrbara"			"Pla de Santa Bàrbara, Poblat ibèric del Pla de Santa Bàrbara"	"Pla de Santa Bàrbara"	"iberian settlement"	"Q11208543"
"Pla de la Trona"	"Pla de la Trona"						
"Pla de Busa"	"Pla de Busa"						
"Pla de Boixadera"	"Pla de Boixadera"						
"Rec de Fenals"	"Rec de Fenals"						
"Pla de Gorgoll"	"Pla de Gorgoll"						
"Pla de Riudellots"	"Pla de Riudellots"						
"Pla de la Banyeta"	"Pla de la Banyeta"						
"Rec de la Rodoreda d'en Comes"	"Rec de la Rodoreda d'en Comes"						
"Rec de Can Mateu"	"Rec de Can Mateu"						
"Pla de Can Maçana"	"Pla de Can Maçana"						
"Pla de les Vaques"	"Pla de les Vaques"						
"Pla del Junyent"	"Pla del Junyent"						
"Pla de Cirera"	"Pla de Cirera"						
"Pla de Sant Pere"	"Pla de Sant Pere"						
"Pla de Puta"	"Pla de Puta"						
"Pla de la Pia"	"Pla de la Pia"						
"Pla de l'Olla"	"Pla de l'Olla"						
"Pla Parella"	"Pla Parella"						
"Rec de Santigosa"	"Rec de Santigosa"						
"carrer d'Olot"	"carrer d'Olot"	"Carretera d'Olot a Riudaura"	"Carretera d'Olot a Riudaura"				
"Rec del Roquer"	"Rec del Roquer"						
"Pla de Rubió"	"Pla de Rubió"						
"Pla del Bertran"	"Pla del Bertran"						
"Pla del Rabasser"	"Pla del Rabasser"						
"Pla del Caseta"	"Pla del Caseta"						
"Carrer de la Font del Ferro"	"Carrer de la Font del Ferro"	"carrer de Nostra Senyora de Lourdes"	"carrer de Nostra Senyora de Lourdes"				
"Carrer Mare de Déu de Lourdes"	"Carrer Mare de Déu de Lourdes"	"carrer de Nostra Senyora de Lourdes"	"carrer de Nostra Senyora de Lourdes"				
"Carrer de la Mare de Déu de Lourdes"	"Carrer de la Mare de Déu de Lourdes"	"carrer de Nostra Senyora de Lourdes"	"carrer de Nostra Senyora de Lourdes"				
"Pla de Gaserans"	"Pla de Gaserans"						
"Pla de Talavera"	"Pla de Talavera"						
"Pla dels Castanyers"	"Pla dels Castanyers"						
"Rec de Gaserans"	"Rec de Gaserans"						
"Pla de les Minen"	"Pla de les Minen"						
"Pla de les Lloses"	"Pla de les Lloses"						
"Pla d'en Serres"	"Pla d'en Serres"						
"Pla del Convent"	"Pla del Convent"						
"Pla del Llobregat"	"Pla del Llobregat"						
"Pla de les Riberes"	"Pla de les Riberes"						
"Pla de les Garrigues"	"Pla de les Garrigues"						
"Pla de Sobrànigues"	"Pla de Sobrànigues"						
"Pla de Roda"	"Pla de Roda"						
"Agulla de la Canal de Tanca"	"Agulla de la Canal de Tanca"						
"Pla de les Estepes"	"Pla de les Estepes"						
"Pla de Ferriol"	"Pla de Ferriol"						
"Pla de la Coromina"	"Pla de la Coromina"						
"Pla del Revell"	"Pla del Revell"						
"Rec de la Font de la Mare de Déu"	"Rec de la Font de la Mare de Déu"						
"Pla dels Tolls"	"Pla dels Tolls"						
"Pla de la Manresana"	"Pla de la Manresana"						
"Pla del Curt"	"Pla del Curt"						
"Pla del Carreter"	"Pla del Carreter"						
"Pla d'Esteve"	"Pla d'Esteve"						
"Pla d'Alcanó"	"Pla d'Alcanó"						
"Pla del Sanatori"	"Pla del Sanatori"						
"Pla de les Llomes"	"Pla de les Llomes"						
"Rec de Sant Josep"	"Rec de Sant Josep"						
"Llac Mora"	"Llac Mora"						
"Pla del Rei"	"Pla del Rei"						
"Pla de la Fita"	"Pla de la Fita"						
"Pla de la Vall de Pujol"	"Pla de la Vall de Pujol"						
"Pla de la Rasa"	"Pla de la Rasa"						
"Pla de la Vaqueria"	"Pla de la Vaqueria"						
"Pla d'Alpicat"	"Pla d'Alpicat"						
"Pla de Vilanova"	"Pla de Vilanova"						
"Pla del Fideuer"	"Pla del Fideuer"						
"Pla de les Carboneres"	"Pla de les Carboneres"						
"Pla dels Ginebres"	"Pla dels Ginebres"						
"Agulla de les Mercès"	"Agulla de les Mercès"						
"Estany de cal Domènec"	"Estany de cal Domènec"						
"Pla de Forn"	"Pla de Forn"						
"Veïnat La Solana"	"Veïnat La Solana"						
"Veïnat de Pocafarina"	"Veïnat de Pocafarina"						
"Pla de la Sàlvia"	"Pla de la Sàlvia"						
"Pla de Roure"	"Pla de Roure"						
"Pla de l'Albercoquer"	"Pla de l'Albercoquer"						
"Estany de Llastres"	"Estany de Llastres"						
"Pla del Correu"	"Pla del Correu"						
"Pla del Sala"	"Pla del Sala"						
"Pla de les Àligues"	"Pla de les Àligues"						
"Pla de na Ponça"	"Pla de na Ponça"						
"Estany de la Murtra"	"Estany de la Murtra"			"Estany de la Murtra, estany de la Murtra"	"Estany de la Murtra"	"wetland"	"Q18005080"
"Pla de Sant Boi"	"Pla de Sant Boi"						
"Pla dels Màrtirs del Setge de 1714"	"Pla dels Màrtirs del Setge de 1714"						
"Estany del Remolar"	"Estany del Remolar"						
"Pla de Pere"	"Pla de Pere"						
"Pla de La Font"	"Pla de La Font"						
"Pla de la Creu de Dalt"	"Pla de la Creu de Dalt"						
"Pla dels Suros"	"Pla dels Suros"						
"Pla d'en Peric"	"Pla d'en Peric"						
"Pla del Misser"	"Pla del Misser"						
"Pla de l'Óssa"	"Pla de l'Óssa"						
"Pla de Pastors"	"Pla de Pastors"						
"Pla d'en Guerra"	"Pla d'en Guerra"						
"Pla de les Cogullades"	"Pla de les Cogullades"						
"Pla del Pica-sal"	"Pla del Pica-sal"						
"Pla del Puig del Tarròs"	"Pla del Puig del Tarròs"						
"Pla del Fuet"	"Pla del Fuet"						
"Pla de la Fira"	"Pla de la Fira"						
"Pla Vermell"	"Pla Vermell"						
"Pla de s'Església"	"Pla de s'Església"						
"Pla de Cal Sis"	"Pla de Cal Sis"						
"Pla de la Quar"	"Pla de la Quar"						
"Rec de Coll de Gavatx"	"Rec de Coll de Gavatx"						
"Còrrec del Mestre Bernat"	"Còrrec del Mestre Bernat"						
"Còrrec del Forn"	"Còrrec del Forn"						
"Còrrec de Comunera"	"Còrrec de Comunera"						
"Pla del Comte"	"Pla del Comte"						
"Rec Novell"	"Rec Novell"						
"Pla de Llengua Eixuta"	"Pla de Llengua Eixuta"						
"Pla de les Fonts Amargues"	"Pla de les Fonts Amargues"						
"Pla de Terrers"	"Pla de Terrers"						
"Estany dels Ponts"	"Estany dels Ponts"						
"Pla de na Tesa"	"Pla de na Tesa"						
"Pla de sa Talaia"	"Pla de sa Talaia"						
"Pla del Baró"	"Pla del Baró"						
"Pla del Tossal Gros"	"Pla del Tossal Gros"						
"Pla de les Tres Fites"	"Pla de les Tres Fites"						
"pla de Roures"	"pla de Roures"						
"Pla de Llosa"	"Pla de Llosa"						
"Pla dels Gavilans"	"Pla dels Gavilans"						
"Pla d'en Torner"	"Pla d'en Torner"						
"Pla del Peiró"	"Pla del Peiró"						
"Pla del Mel"	"Pla del Mel"						
"Pla Bagà"	"Pla Bagà"						
"Pla dels Xurros"	"Pla dels Xurros"						
"Pla de la Barca"	"Pla de la Barca"						
"Pla de Paterna"	"Pla de Paterna"						
"Pla de l'Ànima"	"Pla de l'Ànima"						
"Carrer Músic Bernat"	"Carrer Músic Bernat"						
"Plaça Joan de Joanes"	"Plaça Joan de Joanes"						
"Plaça de Joan de Joanes"	"Plaça de Joan de Joanes"						
"Rec de Ca l'Anton"	"Rec de Ca l'Anton"						
"Pla d'en Selló"	"Pla d'en Selló"						
"Pla de Pinyons"	"Pla de Pinyons"						
"Rec de les Posts"	"Rec de les Posts"						
"Pla de Prats"	"Pla de Prats"						
"Platja Estanys"	"Platja Estanys"	"es Coto"	"es Coto"				
"estany d'en Pedreres"	"estany d'en Pedreres"						
"Estany de Canyamel"	"Estany de Canyamel"						
"Agulla Mar"	"Agulla Mar"						
"Pla de Tresserra"	"Pla de Tresserra"						
"Pla de Masroig"	"Pla de Masroig"						
"Pla Llaneta"	"Pla Llaneta"						
"pla de les botxes"	"pla de les botxes"						
"Pla del Pi Gros"	"Pla del Pi Gros"						
"Pla de Fontanelles"	"Pla de Fontanelles"						
"Pla de Santa Magdalena"	"Pla de Santa Magdalena"						
"Pla del Mestre"	"Pla del Mestre"						
"Pla de les Franqueses"	"Pla de les Franqueses"						
"Pla de Monells"	"Pla de Monells"						
"Pla del Popí"	"Pla del Popí"						
"Pla de Gramenet"	"Pla de Gramenet"						
"Pla de l'Irla"	"Pla de l'Irla"						
"Pla de la Pastereta"	"Pla de la Pastereta"						
"Pla de les Fontanelles"	"Pla de les Fontanelles"						
"Còrrec de la Déu"	"Còrrec de la Déu"						
"Pla de Claret"	"Pla de Claret"						
"Pla d'en Bord"	"Pla d'en Bord"						
"Pla de les Mates"	"Pla de les Mates"						
"Pla de Maries"	"Pla de Maries"						
"Pla de l'Anca"	"Pla de l'Anca"						
"Pla del Perer"	"Pla del Perer"						
"Rec de la Devesa de Niula"	"Rec de la Devesa de Niula"						
"Estany Mal"	"Estany Mal"						
"Pla de les Sitges"	"Pla de les Sitges"						
"Estany d'Ivars d'Urgell"	"Estany d'Ivars d'Urgell"						
"Estany d'Ivars i Vila-sana"	"Estany d'Ivars i Vila-sana"						
"Pla del Sec"	"Pla del Sec"						
"Pla de les Pedroses"	"Pla de les Pedroses"						
"Pla de Mas Bosc"	"Pla de Mas Bosc"						
"Pla de la Casa Nova"	"Pla de la Casa Nova"						
"Llac Relax"	"Llac Relax"						
"Llac infantil"	"Llac infantil"						
"Estany de les Granotes"	"Estany de les Granotes"						
"Pla des Vergers"	"Pla des Vergers"						
"Pla d'Enmig"	"Pla d'Enmig"						
"Pla de Baixamar"	"Pla de Baixamar"						
"Pla de Violes"	"Pla de Violes"						
"Pla de Canes"	"Pla de Canes"						
"Pla de l'Arpella"	"Pla de l'Arpella"						
"Pla de La Comuna"	"Pla de La Comuna"						
"Pla d'Oltra"	"Pla d'Oltra"						
"Pla de Turballos"	"Pla de Turballos"						
"Pla Galera"	"Pla Galera"						
"Pla de Marco, Olocau"	"Pla de Marco, Olocau"						
"Pla de les Simes"	"Pla de les Simes"						
"Pla de Simes"	"Pla de Simes"						
"Pla del Quincaller"	"Pla del Quincaller"						
"Rec Madral"	"Rec Madral"						
"Estany de Vilaüt"	"Estany de Vilaüt"						
"Pla del Pou"	"Pla del Pou"						
"Pla de Can Ribes"	"Pla de Can Ribes"						
"Pla del Cementeri"	"Pla del Cementeri"						
"Pla del Cabot"	"Pla del Cabot"						
"Pla de Ciutat"	"Pla de Ciutat"						
"Pla dels Bassis"	"Pla dels Bassis"						
"Pla de la Coma del Forn"	"Pla de la Coma del Forn"						
"Rec de la Font de la Coromina"	"Rec de la Font de la Coromina"						
"Rec de l'Oli"	"Rec de l'Oli"						
"Pla del Mas Abric"	"Pla del Mas Abric"						
"Pla de l'Illa"	"Pla de l'Illa"						
"Pla de Llagostera"	"Pla de Llagostera"						
"Pla de Llobera"	"Pla de Llobera"						
"Pla de les Tores"	"Pla de les Tores"						
"Pla de les Tanques"	"Pla de les Tanques"						
"Estany i Font de la placeta Francesc Macià"	"Estany i Font de la placeta Francesc Macià"			"Estany i font de la placeta Macià"	"Estany i font de la placeta Macià"	"fountain"	"Q47179485"
"Pla dels Munts"	"Pla dels Munts"						
"Pla de Torrents"	"Pla de Torrents"						
"Pla de Sant Antoni"	"Pla de Sant Antoni"						
"Pla de Corona"	"Pla de Corona"						
"Pla de Sant Gelabert"	"Pla de Sant Gelabert"						
"Pla del Ballester"	"Pla del Ballester"						
"Rec del Purgatori"	"Rec del Purgatori"						
"Pla de la Lleona"	"Pla de la Lleona"						
"Pla del Cingle"	"Pla del Cingle"						
"Pla del Ros"	"Pla del Ros"						
"Pla de Cas Jai"	"Pla de Cas Jai"						
"Pla d'en Gaspar"	"Pla d'en Gaspar"						
"Estany des Cavallet"	"Estany des Cavallet"						
"Pla de Can Font"	"Pla de Can Font"						
"Pla d'Olivars"	"Pla d'Olivars"						
"Pla de Granollers"	"Pla de Granollers"						
"Pla de Jorba"	"Pla de Jorba"						
"Pla de Galí"	"Pla de Galí"						
"Pla de les Piquetes"	"Pla de les Piquetes"						
"Pla del Riu"	"Pla del Riu"						
"Pla de Can Coll"	"Pla de Can Coll"						
"Rec Vell de Sant Vicenç dels Horts"	"Rec Vell de Sant Vicenç dels Horts"						
"Pla del Codony"	"Pla del Codony"						
"Pla d'en Borra"	"Pla d'en Borra"						
"Pla dels Albes"	"Pla dels Albes"						
"Carrer de Mossèn Cinto Verdaguer"	"Carrer de Mossèn Cinto Verdaguer"	"carretera d'Igualada"	"carretera d'Igualada"				
"Pla de sa Vila"	"Pla de sa Vila"						
"Pla de s'Argentera"	"Pla de s'Argentera"						
"estany de Son Bauló"	"estany de Son Bauló"						
"estany de Son Real"	"estany de Son Real"						
"Pla de Jeremies"	"Pla de Jeremies"						
"Pla d'Alou"	"Pla d'Alou"						
"Pla d'en Castell Nou"	"Pla d'en Castell Nou"						
"Pla d'en Castell Vell"	"Pla d'en Castell Vell"						
"Pla d'en Xuclà"	"Pla d'en Xuclà"						
"Pla dels Socs"	"Pla dels Socs"						
"Pla de l'Horta"	"Pla de l'Horta"						
"Pla de Sarrià"	"Pla de Sarrià"						
"Pla de Santa Eugènia"	"Pla de Santa Eugènia"						
"Pla de Martís i Fluvià"	"Pla de Martís i Fluvià"						
"Pla de Conjunta"	"Pla de Conjunta"						
"Pla de Germanells"	"Pla de Germanells"						
"Pla del Mas Grau"	"Pla del Mas Grau"						
"Pla de l'Aulet"	"Pla de l'Aulet"						
"Pla de Santa Margarida"	"Pla de Santa Margarida"						
"Estany de Clarà"	"Estany de Clarà"						
"Estany del Sol"	"Estany del Sol"						
"Estany del Saler"	"Estany del Saler"						
"Pla Baldric"	"Pla Baldric"						
"Pla de la Rogeta"	"Pla de la Rogeta"						
"Llac de Tomí"	"Llac de Tomí"						
"Pla de la Cometa"	"Pla de la Cometa"						
"Pla de Vilafant"	"Pla de Vilafant"						
"Rec de les Forques"	"Rec de les Forques"						
"Pla del Camí de les Eres"	"Pla del Camí de les Eres"						
"Pla de Toralla"	"Pla de Toralla"						
"Pla del Mot"	"Pla del Mot"						
"Pla de Can Cristòfol"	"Pla de Can Cristòfol"						
"Pla del Campillo"	"Pla del Campillo"						
"Pla de les Palmeres"	"Pla de les Palmeres"						
"Pla de les Foies"	"Pla de les Foies"						
"Pla de Barraques"	"Pla de Barraques"						
"Pla del Mesell"	"Pla del Mesell"						
"Pla de Coca"	"Pla de Coca"						
"plaça del Pou"	"plaça del Pou"						
"plaça de Dalt"	"plaça de Dalt"						
"Pla de Graons"	"Pla de Graons"						
"Pla de la Crossa"	"Pla de la Crossa"						
"Pla de la Carrera"	"Pla de la Carrera"						
"Pla del Paller"	"Pla del Paller"						
"Pla de Fonts"	"Pla de Fonts"						
"Pla de Llorà"	"Pla de Llorà"						
"Pla de Cascalls"	"Pla de Cascalls"						
"Pla del Torn"	"Pla del Torn"						
"Pla de Cal Vila-seca"	"Pla de Cal Vila-seca"						
"Rec de Cal Bot"	"Rec de Cal Bot"						
"Pla del Cid"	"Pla del Cid"						
"Pla de la Rufa"	"Pla de la Rufa"						
"Pla de Manlleu"	"Pla de Manlleu"						
"Pla de les Codines"	"Pla de les Codines"						
"Pla de ses Estepes"	"Pla de ses Estepes"						
"Pla de ses Figueretes"	"Pla de ses Figueretes"						
"Pla d'Ebri"	"Pla d'Ebri"						
"Ajuntament d'Almenara"	"Ajuntament d'Almenara"						
"Pla del Ravalet"	"Pla del Ravalet"						
"Pla del Fort"	"Pla del Fort"						
"Pla de l'Avet"	"Pla de l'Avet"						
"Rec de l'Olla i Segalers"	"Rec de l'Olla i Segalers"						
"Rec de l'Olla i de Segalers"	"Rec de l'Olla i de Segalers"						
"Pla de les Malloles"	"Pla de les Malloles"						
"Pla de Barbellons"	"Pla de Barbellons"						
"Pla del Verdeguer"	"Pla del Verdeguer"						
"Pla de Marco"	"Pla de Marco"						
"Pla del Corb"	"Pla del Corb"						
"Pla Casat"	"Pla Casat"						
"Pla de Garbuller"	"Pla de Garbuller"						
"Pla de l'Isidre"	"Pla de l'Isidre"						
"Pla del Pont"	"Pla del Pont"						
"Pla dels Mollons"	"Pla dels Mollons"						
"Pla d'Espí"	"Pla d'Espí"						
"Pla Eixut"	"Pla Eixut"						
"Pla dels Pinarets"	"Pla dels Pinarets"						
"Pla de Castell"	"Pla de Castell"						
"Pla del Bancal del Cavall"	"Pla del Bancal del Cavall"						
"Pla de la Font del Barber"	"Pla de la Font del Barber"						
"Pla de l'Alemany"	"Pla de l'Alemany"						
"Rec de la Bruguera"	"Rec de la Bruguera"						
"Pla de les Monges"	"Pla de les Monges"						
"Pla de les Mosqueres"	"Pla de les Mosqueres"						
"Veïnat de Baix"	"Veïnat de Baix"						
"Pla de Calonge"	"Pla de Calonge"						
"Pla de Ca l'Ignasi"	"Pla de Ca l'Ignasi"						
"Pla de la Salut"	"Pla de la Salut"						
"Mas de Muñoz"	"Mas de Muñoz"						
"Pla de Cap al Soler"	"Pla de Cap al Soler"						
"Pla Gran de l'Ametlla"	"Pla Gran de l'Ametlla"						
"Pla de la Mola"	"Pla de la Mola"						
"Carreró de l'Església"	"Carreró de l'Església"	"el Carreró"	"el Carreró"				
"Pla de la Clusa"	"Pla de la Clusa"						
"Pla de l'Orri"	"Pla de l'Orri"						
"Pla del Roquís"	"Pla del Roquís"						
"Pla de la Serre"	"Pla de la Serre"						
"Pla del Bosc"	"Pla del Bosc"						
"Pla de les Comes"	"Pla de les Comes"						
"Pla de les Burgues"	"Pla de les Burgues"						
"Pla de la Cadavall"	"Pla de la Cadavall"						
"Pla de Vilarig"	"Pla de Vilarig"						
"Pla del Coll del Rei"	"Pla del Coll del Rei"						
"Pla de la Portella"	"Pla de la Portella"						
"Pla d'en Font"	"Pla d'en Font"						
"Pla de Llavanera"	"Pla de Llavanera"						
"Rec de Can Teixidor"	"Rec de Can Teixidor"						
"pla des Llosar"	"pla des Llosar"						
"Pla de la Mala Garba"	"Pla de la Mala Garba"						
"Pla de sa Serp"	"Pla de sa Serp"						
"Pla del Mercat"	"Pla del Mercat"						
"Pla de la Rosa"	"Pla de la Rosa"						
"Còrrec dels Vilars"	"Còrrec dels Vilars"						
"Pla des Ponç"	"Pla des Ponç"						
"Pla de l'Església"	"Pla de l'Església"						
"Pla de Can Simó"	"Pla de Can Simó"						
"Rec de Can Planes"	"Rec de Can Planes"						
"Pla des Porxo"	"Pla des Porxo"						
"Pla de sa Moleta"	"Pla de sa Moleta"						
"Pla de Can Salvà"	"Pla de Can Salvà"						
"Pla d'Onyar"	"Pla d'Onyar"						
"Pla Martí"	"Pla Martí"						
"Pla del Corral de l'Ametller"	"Pla del Corral de l'Ametller"						
"Pla de Fulleda"	"Pla de Fulleda"						
"Rec de Fontanilles"	"Rec de Fontanilles"						
"Rec de les Fonts"	"Rec de les Fonts"						
"Pla dels Gimenells"	"Pla dels Gimenells"						
"Pla de Gimenells"	"Pla de Gimenells"						
"Pla del Xama"	"Pla del Xama"						
"Pla dels Empedrats"	"Pla dels Empedrats"						
"Pla de Saneja"	"Pla de Saneja"						
"Pla d'Isòvol"	"Pla d'Isòvol"						
"Pla de les Molls"	"Pla de les Molls"						
"Pla del Magre"	"Pla del Magre"						
"Pla de les Alzinetes"	"Pla de les Alzinetes"						
"Pla dels Camperols"	"Pla dels Camperols"						
"Pla Damià"	"Pla Damià"						
"Pla del Picot"	"Pla del Picot"						
"Pla del Senyor"	"Pla del Senyor"						
"Pla de l'Albanell"	"Pla de l'Albanell"						
"Pla de Son Nebot"	"Pla de Son Nebot"						
"Pla d'en Boet"	"Pla d'en Boet"						
"Pla dels Capellans"	"Pla dels Capellans"						
"Pla de Sant Simó"	"Pla de Sant Simó"						
"Pla de l'Hort"	"Pla de l'Hort"						
"Pla de la Mare de Déu"	"Pla de la Mare de Déu"						
"Pla d'en Guillemet"	"Pla d'en Guillemet"						
"Pla de Can Saiol"	"Pla de Can Saiol"						
"Pla de Can Vilaró"	"Pla de Can Vilaró"						
"Pla de Santa Àgueda"	"Pla de Santa Àgueda"						
"Pla de l'Estudi"	"Pla de l'Estudi"						
"Pla de les Guàrdies"	"Pla de les Guàrdies"						
"Pla de Clariana"	"Pla de Clariana"						
"Pla de la Costera"	"Pla de la Costera"						
"Pla d'Orba"	"Pla d'Orba"						
"Pla de Coma"	"Pla de Coma"						
"Rec de la Font de la Lladrera"	"Rec de la Font de la Lladrera"						
"Rec de la Font del Martí"	"Rec de la Font del Martí"						
"Rec dels Ferriols"	"Rec dels Ferriols"						
"Rec de Sant Onofre"	"Rec de Sant Onofre"						
"Pla dels Clots"	"Pla dels Clots"						
"Pla del Retor"	"Pla del Retor"						
"Pla del Cirer"	"Pla del Cirer"						
"Pla de Cirer"	"Pla de Cirer"						
"Pla de Mitjà"	"Pla de Mitjà"						
"Pla de Montpedrós"	"Pla de Montpedrós"						
"Còrrec de la Comella"	"Còrrec de la Comella"						
"Pla de Nuncarga"	"Pla de Nuncarga"						
"Pla de l'Aljub"	"Pla de l'Aljub"						
"Pla Bigarrat"	"Pla Bigarrat"						
"Pla d'Arnau"	"Pla d'Arnau"						
"Pla de la Força"	"Pla de la Força"						
"Pla del Tossal"	"Pla del Tossal"						
"Pla de l'Àngel"	"Pla de l'Àngel"						
"Pla de Ràfols"	"Pla de Ràfols"						
"Pla del Piquer"	"Pla del Piquer"						
"Pla de l'Armenter"	"Pla de l'Armenter"						
"Pla Nicolau"	"Pla Nicolau"						
"Pla del Moli"	"Pla del Moli"						
"Estany de la Campana"	"Estany de la Campana"						
"Veïnat de les Mallorquines"	"Veïnat de les Mallorquines"						
"Pla de Salt"	"Pla de Salt"						
"Pla de Puig-arner"	"Pla de Puig-arner"						
"Pla dels Perellons"	"Pla dels Perellons"						
"Pla de la Tanyada"	"Pla de la Tanyada"						
"Pla de les Barqueres"	"Pla de les Barqueres"						
"Pla de la Pregona"	"Pla de la Pregona"						
"Pla de la Basa"	"Pla de la Basa"						
"Pla de la Botera"	"Pla de la Botera"						
"Pla d'en Güell"	"Pla d'en Güell"						
"Pla de Can Pujol"	"Pla de Can Pujol"						
"Veïnat d'en Soler"	"Veïnat d'en Soler"						
"Pla dels Forcs"	"Pla dels Forcs"	"els Quatre Camins"	"els Quatre Camins"				
"Pla de Bassa"	"Pla de Bassa"						
"Pla de Sant Cosme"	"Pla de Sant Cosme"						
"Pla de Sa Grua"	"Pla de Sa Grua"						
"Pla de Menorca"	"Pla de Menorca"						
"Pla de son Moro"	"Pla de son Moro"						
"Pla del Mas Gitano"	"Pla del Mas Gitano"						
"Pla del Martí"	"Pla del Martí"						
"Pla de Rovellons"	"Pla de Rovellons"						
"Pla dels triadors"	"Pla dels triadors"						
"Pla de la Mare de Déu de la Font"	"Pla de la Mare de Déu de la Font"						
"Pla de la Vinya del Boter"	"Pla de la Vinya del Boter"						
"Pla de Sanç"	"Pla de Sanç"						
"Pla de Palou"	"Pla de Palou"						
"Rec de Font Cendra"	"Rec de Font Cendra"						
"camí del Soler Botei"	"camí del Soler Botei"	"Camí a l'ermita de Sant Sebastià"	"Camí a l'ermita de Sant Sebastià"				
"Pla de la Dona Morta"	"Pla de la Dona Morta"						
"Pla de Pinella"	"Pla de Pinella"						
"Pla de Can Sala"	"Pla de Can Sala"						
"Pla del Serrat"	"Pla del Serrat"						
"Pla de Seguró"	"Pla de Seguró"						
"Pla de la Rata"	"Pla de la Rata"						
"Pla de l'Alt"	"Pla de l'Alt"						
"Pla de Tona"	"Pla de Tona"						
"Pla de Mont-rodon"	"Pla de Mont-rodon"						
"Pla de Rull"	"Pla de Rull"						
"Pla de Roquet"	"Pla de Roquet"						
"Pla de Llobet"	"Pla de Llobet"						
"Pla de Vilacolum"	"Pla de Vilacolum"						
"Pla de la Vella"	"Pla de la Vella"						
"Pla de la Meravellosa"	"Pla de la Meravellosa"						
"Pla de l'Infern"	"Pla de l'Infern"						
"Veïnat d'en Roures"	"Veïnat d'en Roures"						
"Pla de Vilablareix"	"Pla de Vilablareix"						
"Rec del regal"	"Rec del regal"						
"Pla de Mas Palau"	"Pla de Mas Palau"						
"Rec de la Font de la Teula"	"Rec de la Font de la Teula"						
"Pla d'en Viver"	"Pla d'en Viver"						
"Pla de Vilaür"	"Pla de Vilaür"						
"Rec dels Arços"	"Rec dels Arços"						
"Rec de les Arques"	"Rec de les Arques"						
"Pla de la Fossa"	"Pla de la Fossa"						
"Pla de Viver"	"Pla de Viver"						
"Pla Reguer"	"Pla Reguer"						
"Pla del Po"	"Pla del Po"						
"Pla d'en Navarro"	"Pla d'en Navarro"						
"Pla del Mano"	"Pla del Mano"						
"Pla de Benavent"	"Pla de Benavent"						
"Pla de Mar"	"Pla de Mar"						
"Estany de Coma-ruga"	"Estany de Coma-ruga"						
"Pla de l'Estrader"	"Pla de l'Estrader"						
"Pla del Torrent"	"Pla del Torrent"						
"Pla de les Serres"	"Pla de les Serres"						
"Pla del Ganxo"	"Pla del Ganxo"						
"Pla de Llerona"	"Pla de Llerona"						
"Pla de Can Draper"	"Pla de Can Draper"						
"Pla d'en Gibert"	"Pla d'en Gibert"						
"Pla del Roure"	"Pla del Roure"						
"Pla de les bruixes"	"Pla de les bruixes"						
"Pla del Pasteral"	"Pla del Pasteral"						
"Pla del Pubill"	"Pla del Pubill"						
"Pla d'Arides"	"Pla d'Arides"						
"Hort d'Iglésies"	"Hort d'Iglésies"						
"Pla de Bous"	"Pla de Bous"						
"Pla del Viudo"	"Pla del Viudo"						
"Pla Foia Boix"	"Pla Foia Boix"						
"Pla Alcoies"	"Pla Alcoies"						
"Pla d'Ebo"	"Pla d'Ebo"						
"Pla del Estret"	"Pla del Estret"						
"Pla del Moro"	"Pla del Moro"						
"Pla de la Barba"	"Pla de la Barba"						
"Pla Barber"	"Pla Barber"						
"Pla de les Llobateres"	"Pla de les Llobateres"						
"Pla de l'Espelt"	"Pla de l'Espelt"						
"Pla del Tro"	"Pla del Tro"						
"pla de la Vinya"	"pla de la Vinya"						
"Pla de Pavia"	"Pla de Pavia"						
"Pla del Morró"	"Pla del Morró"						
"Pla de Tramussar"	"Pla de Tramussar"						
"Mas de Brusca"	"Mas de Brusca"	"la Masia de Brusca"	"la Masia de Brusca"				
"Pla de la Peixera"	"Pla de la Peixera"						
"Rec de l'Obac"	"Rec de l'Obac"						
"Rec de l'Obac (tram sud)"	"Rec de l'Obac (tram sud)"						
"Llac de Can Jalpí"	"Llac de Can Jalpí"						
"Pla de les Gavarres"	"Pla de les Gavarres"						
"Pla des Cavall"	"Pla des Cavall"						
"Pla de ses Morisques"	"Pla de ses Morisques"						
"Pla de Tor"	"Pla de Tor"						
"Rec de Cinyana"	"Rec de Cinyana"						
"Pla dels Moros"	"Pla dels Moros"						
"Pla de Esgarra"	"Pla de Esgarra"						
"Pla d'en Punyet"	"Pla d'en Punyet"						
"Pla de Moragues"	"Pla de Moragues"						
"Pla de Vilamorell"	"Pla de Vilamorell"						
"Pla de Sant Benet"	"Pla de Sant Benet"						
"Pla de Can Roure"	"Pla de Can Roure"						
"Pla Redó"	"Pla Redó"						
"Pla de la Garriga"	"Pla de la Garriga"						
"Pla de Fugues"	"Pla de Fugues"						
"Pla d'en Roca"	"Pla d'en Roca"						
"Pla del Romaní"	"Pla del Romaní"						
"Pla del Porxo"	"Pla del Porxo"						
"Rec de Carme"	"Rec de Carme"						
"Pla de Bruga"	"Pla de Bruga"						
"Pla del Castellot"	"Pla del Castellot"						
"Pla de Matamont"	"Pla de Matamont"						
"Pla dels Cirerers"	"Pla dels Cirerers"						
"Pla de l'Àliga. mirador Sud-Oest"	"Pla de l'Àliga. mirador Sud-Oest"						
"Pla de l'Àliga. mirador Nord-Oest"	"Pla de l'Àliga. mirador Nord-Oest"						
"Pla d'Aitana"	"Pla d'Aitana"						
"Pla de la Codolla"	"Pla de la Codolla"						
"Pla de Banyeres"	"Pla de Banyeres"						
"Pla de Sies"	"Pla de Sies"						
"Pla de Tartera"	"Pla de Tartera"						
"Pla de Mas Caselles"	"Pla de Mas Caselles"						
"Pla de s'Ordi"	"Pla de s'Ordi"						
"Pla del Noguer"	"Pla del Noguer"	"Clot del Noguer"	"Clot del Noguer"				
"Pla Serret"	"Pla Serret"						
"Pla de Conflent"	"Pla de Conflent"						
"Pla del Poble"	"Pla del Poble"						
"Pla d'en Gatell"	"Pla d'en Gatell"						
"Pla de Corbellot"	"Pla de Corbellot"						
"Pla de Sant Romans"	"Pla de Sant Romans"						
"Pla de la Mota"	"Pla de la Mota"						
"Pla del Bronze"	"Pla del Bronze"						
"Pla de les Cabres"	"Pla de les Cabres"						
"Pla les Creuetes"	"Pla les Creuetes"						
"Pla de ses Sitges"	"Pla de ses Sitges"						
"Pla de Lloret"	"Pla de Lloret"						
"Pla d'en Trompa"	"Pla d'en Trompa"						
"Pla de les Basses"	"Pla de les Basses"						
"Pla de la Roquera"	"Pla de la Roquera"						
"Pla Major"	"Pla Major"						
"Pla del Frare"	"Pla del Frare"						
"Pla de Camorra"	"Pla de Camorra"						
"Pla de Gorra"	"Pla de Gorra"						
"Pla d'en Vinyes"	"Pla d'en Vinyes"						
"Pla de la Dinamita"	"Pla de la Dinamita"						
"Pla del Lloro"	"Pla del Lloro"						
"Pla de son Mulet"	"Pla de son Mulet"						
"Camí de S'Ermitori"	"Camí de S'Ermitori"	"camí de Muro"	"camí de Muro"				
"Passeig de la Badia"	"Passeig de la Badia"	"passeig Alfons XIII"	"passeig Alfons XIII"				
"Pla dels Molins"	"Pla dels Molins"						
"Pla de Llíber"	"Pla de Llíber"						
"Pla dels Prats"	"Pla dels Prats"						
"Pla de Mas Vidal"	"Pla de Mas Vidal"						
"Pla de la Sària"	"Pla de la Sària"						
"Pla de ses Veles"	"Pla de ses Veles"						
"Pla de Can Fenosa"	"Pla de Can Fenosa"						
"Pla de Can Bosquerons"	"Pla de Can Bosquerons"						
"Pla de Barenys"	"Pla de Barenys"						
"Còrrec del Cotó"	"Còrrec del Cotó"						
"Pla de Trullars"	"Pla de Trullars"						
"Estany Salat"	"Estany Salat"						
"Pla de Sabaters"	"Pla de Sabaters"						
"Pla de Montclar"	"Pla de Montclar"						
"Pla d'Alella"	"Pla d'Alella"						
"Pla del Manyar"	"Pla del Manyar"						
"Pla de Morell"	"Pla de Morell"						
"Pla de s'Amarador"	"Pla de s'Amarador"						
"Pla del Mal Any"	"Pla del Mal Any"						
"Pla de Golferics"	"Pla de Golferics"						
"Pla Blasco"	"Pla Blasco"						
"Pla dels Frares"	"Pla dels Frares"						
"Pla dels Albats"	"Pla dels Albats"						
"Pla de Mas Cases"	"Pla de Mas Cases"						
"Pla del Bosc Negre"	"Pla del Bosc Negre"						
"Pla de Vedella"	"Pla de Vedella"						
"Pla de Sant Feliu"	"Pla de Sant Feliu"						
"Pla de Cunyà"	"Pla de Cunyà"						
"Pla d'en Bou"	"Pla d'en Bou"						
"Pla de l'Era de les Raboses"	"Pla de l'Era de les Raboses"						
"Camí vell de Bonany"	"Camí vell de Bonany"						
"camí de Son Gorgut"	"camí de Son Gorgut"						
"Pla de Tugues"	"Pla de Tugues"						
"Pla de l'Abella"	"Pla de l'Abella"						
"Pla de la Jonquera"	"Pla de la Jonquera"						
"Pla del Surar"	"Pla del Surar"						
"Pla de la Castella"	"Pla de la Castella"						
"Pla de la Font de la Salut"	"Pla de la Font de la Salut"						
"Pla de la Mariana"	"Pla de la Mariana"						
"Pla dels Pinyers"	"Pla dels Pinyers"						
"Pla de la Flama de Canigó"	"Pla de la Flama de Canigó"						
"Plaça dels Països Catalans"	"Plaça dels Països Catalans"	"plaça de la Foneria"	"plaça de la Foneria"				
"Pla del Carril"	"Pla del Carril"						
"Pla del Sagal"	"Pla del Sagal"						
"Pla de Pinyeres"	"Pla de Pinyeres"						
"Pla Gran de la Cornera"	"Pla Gran de la Cornera"						
"Pla de Gratallops"	"Pla de Gratallops"						
"Pla d'Avaria"	"Pla d'Avaria"						
"Agulla del Perepau"	"Agulla del Perepau"						
"Pla de Pomeres"	"Pla de Pomeres"						
"Pla d'en Maset"	"Pla d'en Maset"						
"Pla de les Moreres"	"Pla de les Moreres"						
"Passatge Tamarit"	"Passatge Tamarit"						
"Pla de Purgatori"	"Pla de Purgatori"						
"Pla de Moixons"	"Pla de Moixons"						
"Pla de l'Ou"	"Pla de l'Ou"						
"Pla de ses Mòdegues"	"Pla de ses Mòdegues"						
"Castell TORRE VILALTA"	"Castell TORRE VILALTA"						
"Pla de Sant Guim Vell"	"Pla de Sant Guim Vell"						
"Pla de Sant Guim"	"Pla de Sant Guim"						
"Pla de ses Formigues"	"Pla de ses Formigues"						
"Pla d'Amigó"	"Pla d'Amigó"						
"Rec de les Corts"	"Rec de les Corts"						
"Pla des Rector"	"Pla des Rector"						
"Pla de Peses"	"Pla de Peses"						
"Pla de Can Server"	"Pla de Can Server"						
"Pla de les Cabanes"	"Pla de les Cabanes"						
"Pla de Miralles"	"Pla de Miralles"						
"Pla de Cal Bosquets"	"Pla de Cal Bosquets"						
"Pla de Cal Riera"	"Pla de Cal Riera"						
"Pla de Santa Cristina"	"Pla de Santa Cristina"						
"Pla del Camí Fondo"	"Pla del Camí Fondo"						
"Pla del Corral Roig"	"Pla del Corral Roig"						
"Pla de la Tossa"	"Pla de la Tossa"						
"Pla de Buc"	"Pla de Buc"						
"Pla de ses Fontanelles"	"Pla de ses Fontanelles"						
"Pla del Llobet"	"Pla del Llobet"						
"Pla del Batlle"	"Pla del Batlle"						
"Pla del Bonet"	"Pla del Bonet"						
"Pla del Bosquet"	"Pla del Bosquet"						
"Pla de les Absoltes"	"Pla de les Absoltes"						
"Estany de Sils"	"Estany de Sils"						
"Pla de sa Bomba"	"Pla de sa Bomba"						
"Llac de ses Mines"	"Llac de ses Mines"						
"Estany Tapat"	"Estany Tapat"						
"Agulla del Mèdol"	"Agulla del Mèdol"						
"Pla de Tollos"	"Pla de Tollos"						
"Pla d'en Saba"	"Pla d'en Saba"						
"Pla del Tabola"	"Pla del Tabola"						
"Rec de la Sínia"	"Rec de la Sínia"						
"Pla de Pinyol"	"Pla de Pinyol"						
"Pla de la Junquera"	"Pla de la Junquera"						
"Pla de Cortina"	"Pla de Cortina"						
"Pla del Clot"	"Pla del Clot"						
"Pla de Gracies a Déu"	"Pla de Gracies a Déu"						
"Pla de Rec"	"Pla de Rec"						
"Còrrec de la Sureda"	"Còrrec de la Sureda"						
"Pla Negret"	"Pla Negret"						
"Pla del Totxar"	"Pla del Totxar"						
"Pla de Petxina"	"Pla de Petxina"						
"Pla del Pinyer"	"Pla del Pinyer"						
"Pla de la Costa"	"Pla de la Costa"						
"Pla de les Ginestes"	"Pla de les Ginestes"						
"Pla de l'Alzinar"	"Pla de l'Alzinar"						
"Pla del Canós"	"Pla del Canós"						
"Pla des Ciurons"	"Pla des Ciurons"						
"Estany de Sant Jordi"	"Estany de Sant Jordi"						
"Estany de Santes Creus"	"Estany de Santes Creus"						
"Pla de la Paridora"	"Pla de la Paridora"						
"Pla d'Almiserà"	"Pla d'Almiserà"						
"Pla dels Covetes"	"Pla dels Covetes"						
"Pla de les Corts"	"Pla de les Corts"						
"Pla del Xato"	"Pla del Xato"						
"Pla del Reu"	"Pla del Reu"						
"Pla de Guàrdia"	"Pla de Guàrdia"						
"Pla d'en Salamó"	"Pla d'en Salamó"						
"Pla de les Teixeres"	"Pla de les Teixeres"						
"Pla de Suau"	"Pla de Suau"						
"Pla de la Molsosa"	"Pla de la Molsosa"						
"Pla de Clarà"	"Pla de Clarà"						
"Pla de Riuràs"	"Pla de Riuràs"						
"Pla de Corbins"	"Pla de Corbins"						
"Pla de Ratera"	"Pla de Ratera"						
"Pla del Ramassar"	"Pla del Ramassar"						
"Pla de Santa Coloma"	"Pla de Santa Coloma"						
"Pla Perdigó"	"Pla Perdigó"						
"Pla de la Pedra Dreta"	"Pla de la Pedra Dreta"						
"Pla de Caldereta"	"Pla de Caldereta"						
"Pla dels Angles"	"Pla dels Angles"						
"Pla de la Cabana"	"Pla de la Cabana"						
"Estany des Tamarells"	"Estany des Tamarells"						
"Pla d'Illes"	"Pla d'Illes"						
"Pla de l'Espasa"	"Pla de l'Espasa"						
"Pla de Punxuat"	"Pla de Punxuat"						
"Pla dels Catalans"	"Pla dels Catalans"						
"Pla de Museros"	"Pla de Museros"						
"Pla de Matacans"	"Pla de Matacans"						
"Pla Timoner"	"Pla Timoner"						
"Veïnat del Mas Riera"	"Veïnat del Mas Riera"						
"Pla de Cabana"	"Pla de Cabana"						
"Pla Saleres"	"Pla Saleres"						
"Pla de Muro"	"Pla de Muro"						
"Pla de les Coves"	"Pla de les Coves"						
"Pla de Sant Pelegrí"	"Pla de Sant Pelegrí"						
"Pla de Codolla"	"Pla de Codolla"						
"Pla de Mollet"	"Pla de Mollet"						
"Carrer les Parres"	"Carrer les Parres"	"la Costereta de les Parres"	"la Costereta de les Parres"				
"Pla la Gralla"	"Pla la Gralla"						
"Pla del Ferrer"	"Pla del Ferrer"						
"Pla de la Quintana"	"Pla de la Quintana"						
"Pla de la Tosa"	"Pla de la Tosa"						
"Veïnat de la Torre"	"Veïnat de la Torre"						
"Pla de Sant Crist"	"Pla de Sant Crist"						
"Pla del pagès"	"Pla del pagès"						
"Pla de la Quirra"	"Pla de la Quirra"						
"Pla de Can Bages"	"Pla de Can Bages"						
"Pla del Canyet"	"Pla del Canyet"						
"Pla del Maset d'Artigues"	"Pla del Maset d'Artigues"						
"Pla de Castellonet"	"Pla de Castellonet"						
"Pla del Xavier"	"Pla del Xavier"						
"Pla dels Voluntaris"	"Pla dels Voluntaris"						
"Pla de Celrà"	"Pla de Celrà"						
"Carrer Ferrer"	"Carrer Ferrer"	"carrer Nou"	"carrer Nou"				
"Pla de Cubells"	"Pla de Cubells"						
"Pla Xiquet"	"Pla Xiquet"						
"plaça de Jaume I"	"plaça de Jaume I"	"Plaça París"	"Plaça París"				
"Pla de Vila"	"Pla de Vila"						
"Pla del Garbí"	"Pla del Garbí"						
"Pla dels Olivars"	"Pla dels Olivars"						
"Pla de la Casa"	"Pla de la Casa"						
"Pla del Castany"	"Pla del Castany"						
"Pla de Fontanilles"	"Pla de Fontanilles"						
"Pla del Milhomes"	"Pla del Milhomes"						
"Pla de Palou"	"Pla de Palou"						
"Pla dels Ballesters"	"Pla dels Ballesters"						
"Pla de la Gessa"	"Pla de la Gessa"						
"Pla de Castellanes"	"Pla de Castellanes"						
"Pla de Prat"	"Pla de Prat"						
"Pla de la Perola"	"Pla de la Perola"						
"Pla de Marco"	"Pla de Marco"						
"Pla de Riart"	"Pla de Riart"						
"Pla de Can Burjó"	"Pla de Can Burjó"						
"Pla d'Artigues"	"Pla d'Artigues"						
"Pla de Lliçà"	"Pla de Lliçà"						
"Pla de Palet"	"Pla de Palet"						
"Pla de Donat"	"Pla de Donat"						
"Pla de les Quadres"	"Pla de les Quadres"						
"Veïnat de Dot"	"Veïnat de Dot"						
"Veïnat De Tomet"	"Veïnat De Tomet"						
"Pla de les Bruixes II"	"Pla de les Bruixes II"						
"Pla de Santa Creu"	"Pla de Santa Creu"						
"Pla de Goma"	"Pla de Goma"						
"Pla de Tabac"	"Pla de Tabac"						
"Llac de Navarcles"	"Llac de Navarcles"						
"Pla del Soldat"	"Pla del Soldat"						
"Pla de Can Sorts"	"Pla de Can Sorts"						
"Llac blau"	"Llac blau"						
"Rec des Coll"	"Rec des Coll"						
"Pla Sebastià"	"Pla Sebastià"						
"Mas d'en Fermí"	"Mas d'en Fermí"	"cal Figuerola"	"cal Figuerola"				
"Pla de les Lligones"	"Pla de les Lligones"						
"Rec Gros de Prullans"	"Rec Gros de Prullans"						
"Pla de les Forcades"	"Pla de les Forcades"						
"Pla de Mollà"	"Pla de Mollà"						
"Pla Nadal"	"Pla Nadal"						
"Pla del Comú"	"Pla del Comú"						
"Pla de Fonollar"	"Pla de Fonollar"						
"Pla d'en Mas"	"Pla d'en Mas"						
"Llac Europa"	"Llac Europa"						
"Pla d'Hortolà"	"Pla d'Hortolà"						
"Pla de Sant Cristòfol"	"Pla de Sant Cristòfol"						
"Rec del Mas"	"Rec del Mas"						
"Pla de l'Esteve"	"Pla de l'Esteve"						
"Mas Isard"	"Mas Isard"						
"Pla de Vilardell"	"Pla de Vilardell"						
"Pla d'en Julià"	"Pla d'en Julià"						
"Pla del Mas Roure"	"Pla del Mas Roure"						
"Pla del Novell"	"Pla del Novell"						
"Avinguda Quatre"	"Avinguda Quatre"	"avinguda 4"	"avinguda 4"				
"Pla de Lluça"	"Pla de Lluça"						
"Pla d'en Geli"	"Pla d'en Geli"						
"Pla d'en Rai"	"Pla d'en Rai"						
"Pla de Biniali"	"Pla de Biniali"						
"Pla d'en Pou"	"Pla d'en Pou"						
"Llac del Molí de Magalló"	"Llac del Molí de Magalló"						
"Pla dels Canons"	"Pla dels Canons"						
"Pla de Can Revella"	"Pla de Can Revella"						
"Pla del Garrofí"	"Pla del Garrofí"						
"Pla Dellà"	"Pla Dellà"						
"Pla de les Hortes"	"Pla de les Hortes"						
"Pla de Penedès"	"Pla de Penedès"						
"Pla de la Virosella"	"Pla de la Virosella"						
"Pla de Sant Ermengol"	"Pla de Sant Ermengol"						
"Pla de l'Aire"	"Pla de l'Aire"						
"Rec de l'Eral"	"Rec de l'Eral"						
"Pla dels Trotes"	"Pla dels Trotes"						
"Pla de la Codina"	"Pla de la Codina"						
"Pla d'Ullà"	"Pla d'Ullà"						
"Pla de Parlavà"	"Pla de Parlavà"						
"Pla de Sant Jaume"	"Pla de Sant Jaume"						
"Pla del Viver"	"Pla del Viver"						
"Pla d'Anglesola"	"Pla d'Anglesola"						
"Pla de Clua"	"Pla de Clua"						
"Pla de l'Ermità"	"Pla de l'Ermità"						
"Pla de Matamala"	"Pla de Matamala"						
"Pla d'en Ramon"	"Pla d'en Ramon"						
"Pla dels Moletons"	"Pla dels Moletons"						
"Pla de Vilar de Canes"	"Pla de Vilar de Canes"						
"Pla dels Palmers"	"Pla dels Palmers"						
"Pla de Segura"	"Pla de Segura"						
"Rec del Solà"	"Rec del Solà"						
"Pla de l'Anton"	"Pla de l'Anton"						
"Pla de la Galera"	"Pla de la Galera"						
"Carrer Unitat d'Execució"	"Carrer Unitat d'Execució"						
"Pla del Pedregar"	"Pla del Pedregar"						
"Pla de Montclús"	"Pla de Montclús"						
"Pla Serè"	"Pla Serè"						
"Carrer del Bon Sol"	"Carrer del Bon Sol"	"camí de Can Campins"	"camí de Can Campins"				
